geocode,municipio,uf,disease,period,rural,urban,total
110001, Alta Floresta D'Oeste,11,CL,2004-2008,188,65,253
110037, Alto Alegre dos Parecis,11,CL,2004-2008,86,25,111
110040, Alto Paraíso,11,CL,2004-2008,65,22,87
110034, Alvorada D'Oeste,11,CL,2004-2008,79,39,118
110002, Ariquemes,11,CL,2004-2008,89,299,388
110045, Buritis,11,CL,2004-2008,214,93,307
110003, Cabixi,11,CL,2004-2008,27,20,47
110060, Cacaulândia,11,CL,2004-2008,45,18,63
110004, Cacoal,11,CL,2004-2008,246,247,493
110070, Campo Novo de Rondônia,11,CL,2004-2008,101,35,136
110080, Candeias do Jamari,11,CL,2004-2008,18,25,43
110090, Castanheiras,11,CL,2004-2008,27,3,30
110005, Cerejeiras,11,CL,2004-2008,10,39,49
110092, Chupinguaia,11,CL,2004-2008,94,24,118
110006, Colorado do Oeste,11,CL,2004-2008,40,66,106
110007, Corumbiara,11,CL,2004-2008,34,6,40
110008, Costa Marques,11,CL,2004-2008,142,51,193
110094, Cujubim,11,CL,2004-2008,67,59,126
110009, Espigão D'Oeste,11,CL,2004-2008,160,99,259
110100, Governador Jorge Teixeira,11,CL,2004-2008,92,10,102
110010, Guajará-Mirim,11,CL,2004-2008,37,98,135
110110, Itapuã do Oeste,11,CL,2004-2008,17,13,30
110011, Jaru,11,CL,2004-2008,88,124,212
110012, Ji-Paraná,11,CL,2004-2008,61,254,315
110013, Machadinho D'Oeste,11,CL,2004-2008,169,83,252
110120, Ministro Andreazza,11,CL,2004-2008,44,8,52
110130, Mirante da Serra,11,CL,2004-2008,69,24,93
110140, Monte Negro,11,CL,2004-2008,121,51,172
110014, Nova Brasilândia D'Oeste,11,CL,2004-2008,90,21,111
110033, Nova Mamoré,11,CL,2004-2008,79,29,108
110143, Nova União,11,CL,2004-2008,40,7,47
110050, Novo Horizonte do Oeste,11,CL,2004-2008,80,12,92
110015, Ouro Preto do Oeste,11,CL,2004-2008,23,53,76
110145, Parecis,11,CL,2004-2008,109,31,140
110018, Pimenta Bueno,11,CL,2004-2008,116,156,272
110146, Pimenteiras do Oeste,11,CL,2004-2008,3,5,8
110020, Porto Velho,11,CL,2004-2008,214,333,547
110025, Presidente Médici,11,CL,2004-2008,44,21,65
110147, Primavera de Rondônia,11,CL,2004-2008,27,10,37
110026, Rio Crespo,11,CL,2004-2008,35,14,49
110028, Rolim de Moura,11,CL,2004-2008,77,145,222
110029, Santa Luzia D'Oeste,11,CL,2004-2008,34,23,57
110148, São Felipe D'Oeste,11,CL,2004-2008,28,13,41
110149, São Francisco do Guaporé,11,CL,2004-2008,105,40,145
110032, São Miguel do Guaporé,11,CL,2004-2008,99,18,117
110150, Seringueiras,11,CL,2004-2008,83,32,115
110155, Teixeirópolis,11,CL,2004-2008,9,7,16
110160, Theobroma,11,CL,2004-2008,38,6,44
110170, Urupá,11,CL,2004-2008,23,10,33
110175, Vale do Anari,11,CL,2004-2008,33,15,48
110180, Vale do Paraíso,11,CL,2004-2008,28,8,36
110030, Vilhena,11,CL,2004-2008,77,463,540
110000, Município ignorado - RO,11,CL,2004-2008,4,0,4
120001, Acrelândia,12,CL,2004-2008,117,41,158
120005, Assis Brasil,12,CL,2004-2008,221,64,285
120010, Brasiléia,12,CL,2004-2008,291,159,450
120013, Bujari,12,CL,2004-2008,145,25,170
120017, Capixaba,12,CL,2004-2008,147,51,198
120020, Cruzeiro do Sul,12,CL,2004-2008,58,88,146
120025, Epitaciolândia,12,CL,2004-2008,58,175,233
120030, Feijó,12,CL,2004-2008,133,49,182
120032, Jordão,12,CL,2004-2008,39,12,51
120033, Mâncio Lima,12,CL,2004-2008,55,23,78
120034, Manoel Urbano,12,CL,2004-2008,106,80,186
120035, Marechal Thaumaturgo,12,CL,2004-2008,112,20,132
120038, Plácido de Castro,12,CL,2004-2008,149,127,276
120080, Porto Acre,12,CL,2004-2008,190,99,289
120039, Porto Walter,12,CL,2004-2008,42,4,46
120040, Rio Branco,12,CL,2004-2008,599,1075,1674
120042, Rodrigues Alves,12,CL,2004-2008,23,4,27
120043, Santa Rosa do Purus,12,CL,2004-2008,46,28,74
120050, Sena Madureira,12,CL,2004-2008,477,142,619
120045, Senador Guiomard,12,CL,2004-2008,28,66,94
120060, Tarauacá,12,CL,2004-2008,88,72,160
120070, Xapuri,12,CL,2004-2008,755,22,777
120000, Município ignorado - AC,12,CL,2004-2008,0,2,2
130002, Alvarães,13,CL,2004-2008,9,2,11
130008, Anamã,13,CL,2004-2008,5,2,7
130010, Anori,13,CL,2004-2008,1,0,1
130014, Apuí,13,CL,2004-2008,124,93,217
130020, Atalaia do Norte,13,CL,2004-2008,26,11,37
130030, Autazes,13,CL,2004-2008,36,14,50
130040, Barcelos,13,CL,2004-2008,43,49,92
130050, Barreirinha,13,CL,2004-2008,15,2,17
130060, Benjamin Constant,13,CL,2004-2008,10,8,18
130063, Beruri,13,CL,2004-2008,2,0,2
130068, Boa Vista do Ramos,13,CL,2004-2008,6,3,9
130070, Boca do Acre,13,CL,2004-2008,189,94,283
130080, Borba,13,CL,2004-2008,27,21,48
130083, Caapiranga,13,CL,2004-2008,12,11,23
130090, Canutama,13,CL,2004-2008,15,8,23
130100, Carauari,13,CL,2004-2008,13,64,77
130110, Careiro,13,CL,2004-2008,30,4,34
130115, Careiro da Várzea,13,CL,2004-2008,3,0,3
130120, Coari,13,CL,2004-2008,16,87,103
130130, Codajás,13,CL,2004-2008,10,8,18
130140, Eirunepé,13,CL,2004-2008,85,36,121
130150, Envira,13,CL,2004-2008,65,53,118
130160, Fonte Boa,13,CL,2004-2008,1,2,3
130165, Guajará,13,CL,2004-2008,21,11,32
130170, Humaitá,13,CL,2004-2008,103,115,218
130180, Ipixuna,13,CL,2004-2008,40,27,67
130185, Iranduba,13,CL,2004-2008,15,4,19
130190, Itacoatiara,13,CL,2004-2008,439,211,650
130195, Itamarati,13,CL,2004-2008,6,4,10
130200, Itapiranga,13,CL,2004-2008,14,18,32
130210, Japurá,13,CL,2004-2008,4,3,7
130220, Juruá,13,CL,2004-2008,2,14,16
130230, Jutaí,13,CL,2004-2008,1,3,4
130240, Lábrea,13,CL,2004-2008,94,114,208
130250, Manacapuru,13,CL,2004-2008,61,52,113
130255, Manaquiri,13,CL,2004-2008,4,1,5
130260, Manaus,13,CL,2004-2008,697,3005,3702
130270, Manicoré,13,CL,2004-2008,52,31,83
130280, Maraã,13,CL,2004-2008,5,2,7
130290, Maués,13,CL,2004-2008,71,52,123
130300, Nhamundá,13,CL,2004-2008,26,7,33
130310, Nova Olinda do Norte,13,CL,2004-2008,9,10,19
130320, Novo Airão,13,CL,2004-2008,25,30,55
130330, Novo Aripuanã,13,CL,2004-2008,50,42,92
130340, Parintins,13,CL,2004-2008,32,40,72
130350, Pauini,13,CL,2004-2008,26,10,36
130353, Presidente Figueiredo,13,CL,2004-2008,721,212,933
130356, Rio Preto da Eva,13,CL,2004-2008,1592,195,1787
130360, Santa Isabel do Rio Negro,13,CL,2004-2008,42,27,69
130370, Santo Antônio do Içá,13,CL,2004-2008,9,3,12
130380, São Gabriel da Cachoeira,13,CL,2004-2008,56,40,96
130390, São Paulo de Olivença,13,CL,2004-2008,1,4,5
130395, São Sebastião do Uatumã,13,CL,2004-2008,4,13,17
130400, Silves,13,CL,2004-2008,20,18,38
130406, Tabatinga,13,CL,2004-2008,5,41,46
130410, Tapauá,13,CL,2004-2008,27,18,45
130420, Tefé,13,CL,2004-2008,24,46,70
130423, Tonantins,13,CL,2004-2008,2,0,2
130426, Uarini,13,CL,2004-2008,12,5,17
130430, Urucará,13,CL,2004-2008,11,13,24
130440, Urucurituba,13,CL,2004-2008,1,2,3
140005, Alto Alegre,14,CL,2004-2008,33,14,47
140002, Amajari,14,CL,2004-2008,22,3,25
140010, Boa Vista,14,CL,2004-2008,10,338,348
140015, Bonfim,14,CL,2004-2008,8,8,16
140017, Cantá,14,CL,2004-2008,29,2,31
140020, Caracaraí,14,CL,2004-2008,34,59,93
140023, Caroebe,14,CL,2004-2008,175,60,235
140028, Iracema,14,CL,2004-2008,9,16,25
140030, Mucajaí,14,CL,2004-2008,32,32,64
140040, Normandia,14,CL,2004-2008,1,0,1
140045, Pacaraima,14,CL,2004-2008,33,189,222
140047, Rorainópolis,14,CL,2004-2008,164,82,246
140050, São João da Baliza,14,CL,2004-2008,22,42,64
140060, São Luiz,14,CL,2004-2008,16,21,37
140070, Uiramutã,14,CL,2004-2008,24,0,24
150010, Abaetetuba,15,CL,2004-2008,25,19,44
150013, Abel Figueiredo,15,CL,2004-2008,19,50,69
150020, Acará,15,CL,2004-2008,76,30,106
150030, Afuá,15,CL,2004-2008,17,2,19
150034, Água Azul do Norte,15,CL,2004-2008,48,22,70
150040, Alenquer,15,CL,2004-2008,72,296,368
150050, Almeirim,15,CL,2004-2008,336,148,484
150060, Altamira,15,CL,2004-2008,188,556,744
150070, Anajás,15,CL,2004-2008,20,11,31
150080, Ananindeua,15,CL,2004-2008,1,19,20
150085, Anapu,15,CL,2004-2008,246,121,367
150090, Augusto Corrêa,15,CL,2004-2008,63,8,71
150095, Aurora do Pará,15,CL,2004-2008,45,18,63
150100, Aveiro,15,CL,2004-2008,66,12,78
150110, Bagre,15,CL,2004-2008,90,7,97
150120, Baião,15,CL,2004-2008,129,19,148
150125, Bannach,15,CL,2004-2008,18,2,20
150130, Barcarena,15,CL,2004-2008,6,13,19
150140, Belém,15,CL,2004-2008,4,57,61
150145, Belterra,15,CL,2004-2008,105,52,157
150150, Benevides,15,CL,2004-2008,4,5,9
150157, Bom Jesus do Tocantins,15,CL,2004-2008,21,15,36
150160, Bonito,15,CL,2004-2008,3,1,4
150170, Bragança,15,CL,2004-2008,103,86,189
150172, Brasil Novo,15,CL,2004-2008,200,48,248
150175, Brejo Grande do Araguaia,15,CL,2004-2008,3,8,11
150178, Breu Branco,15,CL,2004-2008,130,193,323
150180, Breves,15,CL,2004-2008,16,41,57
150190, Bujaru,15,CL,2004-2008,1,1,2
150200, Cachoeira do Arari,15,CL,2004-2008,5,3,8
150195, Cachoeira do Piriá,15,CL,2004-2008,101,10,111
150210, Cametá,15,CL,2004-2008,78,14,92
150215, Canaã dos Carajás,15,CL,2004-2008,21,32,53
150220, Capanema,15,CL,2004-2008,10,34,44
150230, Capitão Poço,15,CL,2004-2008,43,46,89
150240, Castanhal,15,CL,2004-2008,16,82,98
150250, Chaves,15,CL,2004-2008,4,0,4
150260, Colares,15,CL,2004-2008,7,0,7
150270, Conceição do Araguaia,15,CL,2004-2008,22,33,55
150275, Concórdia do Pará,15,CL,2004-2008,11,10,21
150276, Cumaru do Norte,15,CL,2004-2008,35,27,62
150277, Curionópolis,15,CL,2004-2008,20,62,82
150280, Curralinho,15,CL,2004-2008,45,12,57
150285, Curuá,15,CL,2004-2008,9,12,21
150290, Curuçá,15,CL,2004-2008,1,2,3
150293, Dom Eliseu,15,CL,2004-2008,98,515,613
150295, Eldorado do Carajás,15,CL,2004-2008,156,85,241
150300, Faro,15,CL,2004-2008,9,29,38
150304, Floresta do Araguaia,15,CL,2004-2008,28,39,67
150307, Garrafão do Norte,15,CL,2004-2008,50,7,57
150309, Goianésia do Pará,15,CL,2004-2008,122,193,315
150310, Gurupá,15,CL,2004-2008,26,10,36
150320, Igarapé-Açu,15,CL,2004-2008,7,9,16
150330, Igarapé-Miri,15,CL,2004-2008,30,17,47
150340, Inhangapi,15,CL,2004-2008,4,6,10
150345, Ipixuna do Pará,15,CL,2004-2008,126,36,162
150350, Irituia,15,CL,2004-2008,51,14,65
150360, Itaituba,15,CL,2004-2008,150,476,626
150370, Itupiranga,15,CL,2004-2008,122,79,201
150375, Jacareacanga,15,CL,2004-2008,36,34,70
150380, Jacundá,15,CL,2004-2008,7,153,160
150390, Juruti,15,CL,2004-2008,89,50,139
150400, Limoeiro do Ajuru,15,CL,2004-2008,6,2,8
150405, Mãe do Rio,15,CL,2004-2008,13,22,35
150420, Marabá,15,CL,2004-2008,327,376,703
150430, Maracanã,15,CL,2004-2008,3,0,3
150440, Marapanim,15,CL,2004-2008,4,2,6
150442, Marituba,15,CL,2004-2008,2,11,13
150445, Medicilândia,15,CL,2004-2008,935,177,1112
150450, Melgaço,15,CL,2004-2008,14,13,27
150460, Mocajuba,15,CL,2004-2008,78,51,129
150470, Moju,15,CL,2004-2008,334,24,358
150480, Monte Alegre,15,CL,2004-2008,441,105,546
150490, Muaná,15,CL,2004-2008,12,3,15
150495, Nova Esperança do Piriá,15,CL,2004-2008,66,40,106
150497, Nova Ipixuna,15,CL,2004-2008,17,19,36
150500, Nova Timboteua,15,CL,2004-2008,13,6,19
150503, Novo Progresso,15,CL,2004-2008,110,230,340
150506, Novo Repartimento,15,CL,2004-2008,412,122,534
150510, Óbidos,15,CL,2004-2008,291,101,392
150520, Oeiras do Pará,15,CL,2004-2008,91,22,113
150530, Oriximiná,15,CL,2004-2008,170,303,473
150540, Ourém,15,CL,2004-2008,11,6,17
150543, Ourilândia do Norte,15,CL,2004-2008,31,66,97
150548, Pacajá,15,CL,2004-2008,310,118,428
150549, Palestina do Pará,15,CL,2004-2008,1,4,5
150550, Paragominas,15,CL,2004-2008,271,604,875
150553, Parauapebas,15,CL,2004-2008,68,356,424
150555, Pau D'Arco,15,CL,2004-2008,15,10,25
150560, Peixe-Boi,15,CL,2004-2008,5,0,5
150563, Piçarra,15,CL,2004-2008,24,7,31
150565, Placas,15,CL,2004-2008,144,97,241
150580, Portel,15,CL,2004-2008,327,144,471
150590, Porto de Moz,15,CL,2004-2008,47,40,87
150600, Prainha,15,CL,2004-2008,209,24,233
150610, Primavera,15,CL,2004-2008,4,7,11
150611, Quatipuru,15,CL,2004-2008,0,2,2
150613, Redenção,15,CL,2004-2008,11,354,365
150616, Rio Maria,15,CL,2004-2008,11,64,75
150618, Rondon do Pará,15,CL,2004-2008,59,371,430
150619, Rurópolis,15,CL,2004-2008,100,110,210
150620, Salinópolis,15,CL,2004-2008,10,38,48
150630, Salvaterra,15,CL,2004-2008,10,2,12
150650, Santa Izabel do Pará,15,CL,2004-2008,13,9,22
150655, Santa Luzia do Pará,15,CL,2004-2008,16,13,29
150658, Santa Maria das Barreiras,15,CL,2004-2008,30,19,49
150660, Santa Maria do Pará,15,CL,2004-2008,25,16,41
150670, Santana do Araguaia,15,CL,2004-2008,76,155,231
150680, Santarém,15,CL,2004-2008,405,472,877
150690, Santarém Novo,15,CL,2004-2008,6,0,6
150700, Santo Antônio do Tauá,15,CL,2004-2008,3,8,11
150710, São Caetano de Odivelas,15,CL,2004-2008,3,2,5
150715, São Domingos do Araguaia,15,CL,2004-2008,66,75,141
150720, São Domingos do Capim,15,CL,2004-2008,19,3,22
150730, São Félix do Xingu,15,CL,2004-2008,205,94,299
150740, São Francisco do Pará,15,CL,2004-2008,10,1,11
150745, São Geraldo do Araguaia,15,CL,2004-2008,56,86,142
150746, São João da Ponta,15,CL,2004-2008,5,0,5
150747, São João de Pirabas,15,CL,2004-2008,8,0,8
150750, São João do Araguaia,15,CL,2004-2008,21,3,24
150760, São Miguel do Guamá,15,CL,2004-2008,18,23,41
150770, São Sebastião da Boa Vista,15,CL,2004-2008,7,2,9
150775, Sapucaia,15,CL,2004-2008,4,4,8
150780, Senador José Porfírio,15,CL,2004-2008,54,58,112
150790, Soure,15,CL,2004-2008,1,0,1
150795, Tailândia,15,CL,2004-2008,433,265,698
150796, Terra Alta,15,CL,2004-2008,4,0,4
150797, Terra Santa,15,CL,2004-2008,22,64,86
150800, Tomé-Açu,15,CL,2004-2008,483,176,659
150803, Tracuateua,15,CL,2004-2008,21,9,30
150805, Trairão,15,CL,2004-2008,117,53,170
150808, Tucumã,15,CL,2004-2008,51,134,185
150810, Tucuruí,15,CL,2004-2008,16,294,310
150812, Ulianópolis,15,CL,2004-2008,152,296,448
150815, Uruará,15,CL,2004-2008,602,140,742
150820, Vigia,15,CL,2004-2008,1,3,4
150830, Viseu,15,CL,2004-2008,45,3,48
150835, Vitória do Xingu,15,CL,2004-2008,28,4,32
150840, Xinguara,15,CL,2004-2008,11,61,72
150000, Município ignorado - PA,15,CL,2004-2008,2,0,2
160010, Amapá,16,CL,2004-2008,6,8,14
160020, Calçoene,16,CL,2004-2008,128,34,162
160021, Cutias,16,CL,2004-2008,2,0,2
160023, Ferreira Gomes,16,CL,2004-2008,15,4,19
160027, Laranjal do Jari,16,CL,2004-2008,197,594,791
160030, Macapá,16,CL,2004-2008,39,410,449
160040, Mazagão,16,CL,2004-2008,158,18,176
160050, Oiapoque,16,CL,2004-2008,126,507,633
160015, Pedra Branca do Amapari,16,CL,2004-2008,149,74,223
160053, Porto Grande,16,CL,2004-2008,469,111,580
160055, Pracuúba,16,CL,2004-2008,12,2,14
160060, Santana,16,CL,2004-2008,65,150,215
160005, Serra do Navio,16,CL,2004-2008,134,82,216
160070, Tartarugalzinho,16,CL,2004-2008,116,41,157
160080, Vitória do Jari,16,CL,2004-2008,24,75,99
160000, Município ignorado - AP,16,CL,2004-2008,2,1,3
170025, Abreulândia,17,CL,2004-2008,10,11,21
170030, Aguiarnópolis,17,CL,2004-2008,2,7,9
170035, Aliança do Tocantins,17,CL,2004-2008,0,6,6
170040, Almas,17,CL,2004-2008,3,9,12
170100, Ananás,17,CL,2004-2008,15,81,96
170105, Angico,17,CL,2004-2008,5,3,8
170110, Aparecida do Rio Negro,17,CL,2004-2008,9,22,31
170130, Aragominas,17,CL,2004-2008,4,5,9
170190, Araguacema,17,CL,2004-2008,18,4,22
170200, Araguaçu,17,CL,2004-2008,16,26,42
170210, Araguaína,17,CL,2004-2008,16,151,167
170215, Araguanã,17,CL,2004-2008,2,8,10
170220, Araguatins,17,CL,2004-2008,16,23,39
170230, Arapoema,17,CL,2004-2008,5,10,15
170240, Arraias,17,CL,2004-2008,3,1,4
170255, Augustinópolis,17,CL,2004-2008,2,12,14
170270, Aurora do Tocantins,17,CL,2004-2008,8,5,13
170290, Axixá do Tocantins,17,CL,2004-2008,5,7,12
170300, Babaçulândia,17,CL,2004-2008,11,8,19
170305, Bandeirantes do Tocantins,17,CL,2004-2008,1,5,6
170307, Barra do Ouro,17,CL,2004-2008,2,3,5
170310, Barrolândia,17,CL,2004-2008,1,9,10
170320, Bernardo Sayão,17,CL,2004-2008,1,1,2
170330, Bom Jesus do Tocantins,17,CL,2004-2008,4,7,11
170360, Brasilândia do Tocantins,17,CL,2004-2008,0,7,7
170370, Brejinho de Nazaré,17,CL,2004-2008,3,4,7
170380, Buriti do Tocantins,17,CL,2004-2008,3,1,4
170382, Cachoeirinha,17,CL,2004-2008,0,6,6
170384, Campos Lindos,17,CL,2004-2008,3,5,8
170386, Cariri do Tocantins,17,CL,2004-2008,0,2,2
170388, Carmolândia,17,CL,2004-2008,1,1,2
170389, Carrasco Bonito,17,CL,2004-2008,0,3,3
170390, Caseara,17,CL,2004-2008,20,12,32
170410, Centenário,17,CL,2004-2008,17,16,33
170510, Chapada da Natividade,17,CL,2004-2008,1,0,1
170460, Chapada de Areia,17,CL,2004-2008,0,1,1
170550, Colinas do Tocantins,17,CL,2004-2008,1,30,31
171670, Colméia,17,CL,2004-2008,2,9,11
170555, Combinado,17,CL,2004-2008,1,1,2
170600, Couto Magalhães,17,CL,2004-2008,19,13,32
170610, Cristalândia,17,CL,2004-2008,14,16,30
170625, Crixás do Tocantins,17,CL,2004-2008,4,0,4
170650, Darcinópolis,17,CL,2004-2008,9,3,12
170700, Dianópolis,17,CL,2004-2008,45,46,91
170710, Divinópolis do Tocantins,17,CL,2004-2008,9,12,21
170720, Dois Irmãos do Tocantins,17,CL,2004-2008,13,3,16
170730, Dueré,17,CL,2004-2008,12,3,15
170740, Esperantina,17,CL,2004-2008,4,8,12
170755, Fátima,17,CL,2004-2008,2,5,7
170770, Filadélfia,17,CL,2004-2008,2,4,6
170820, Formoso do Araguaia,17,CL,2004-2008,6,13,19
170825, Fortaleza do Tabocão,17,CL,2004-2008,5,9,14
170830, Goianorte,17,CL,2004-2008,10,7,17
170900, Goiatins,17,CL,2004-2008,9,3,12
170930, Guaraí,17,CL,2004-2008,15,88,103
170950, Gurupi,17,CL,2004-2008,1,33,34
171050, Itacajá,17,CL,2004-2008,15,20,35
171070, Itaguatins,17,CL,2004-2008,3,1,4
171090, Itapiratins,17,CL,2004-2008,8,2,10
171110, Itaporã do Tocantins,17,CL,2004-2008,5,4,9
171150, Jaú do Tocantins,17,CL,2004-2008,19,11,30
171190, Lagoa da Confusão,17,CL,2004-2008,13,15,28
171200, Lajeado,17,CL,2004-2008,4,3,7
171215, Lavandeira,17,CL,2004-2008,7,5,12
171240, Lizarda,17,CL,2004-2008,8,2,10
171245, Luzinópolis,17,CL,2004-2008,5,11,16
171250, Marianópolis do Tocantins,17,CL,2004-2008,19,20,39
171270, Mateiros,17,CL,2004-2008,1,0,1
171280, Maurilândia do Tocantins,17,CL,2004-2008,2,2,4
171320, Miracema do Tocantins,17,CL,2004-2008,11,29,40
171330, Miranorte,17,CL,2004-2008,2,16,18
171360, Monte do Carmo,17,CL,2004-2008,30,35,65
171370, Monte Santo do Tocantins,17,CL,2004-2008,2,4,6
171395, Muricilândia,17,CL,2004-2008,2,1,3
171430, Nazaré,17,CL,2004-2008,6,12,18
171488, Nova Olinda,17,CL,2004-2008,4,6,10
171500, Nova Rosalândia,17,CL,2004-2008,5,10,15
171510, Novo Acordo,17,CL,2004-2008,1,0,1
171515, Novo Alegre,17,CL,2004-2008,4,10,14
171525, Novo Jardim,17,CL,2004-2008,9,14,23
172100, Palmas,17,CL,2004-2008,14,99,113
171570, Palmeirante,17,CL,2004-2008,3,0,3
171380, Palmeiras do Tocantins,17,CL,2004-2008,2,1,3
171575, Palmeirópolis,17,CL,2004-2008,4,18,22
171610, Paraíso do Tocantins,17,CL,2004-2008,4,39,43
171620, Paranã,17,CL,2004-2008,3,0,3
171630, Pau D'Arco,17,CL,2004-2008,2,3,5
171650, Pedro Afonso,17,CL,2004-2008,8,22,30
171660, Peixe,17,CL,2004-2008,1,4,5
171665, Pequizeiro,17,CL,2004-2008,0,3,3
171700, Pindorama do Tocantins,17,CL,2004-2008,3,14,17
171720, Piraquê,17,CL,2004-2008,11,8,19
171750, Pium,17,CL,2004-2008,13,12,25
171780, Ponte Alta do Bom Jesus,17,CL,2004-2008,1,3,4
171790, Ponte Alta do Tocantins,17,CL,2004-2008,32,33,65
171800, Porto Alegre do Tocantins,17,CL,2004-2008,4,7,11
171820, Porto Nacional,17,CL,2004-2008,14,49,63
171830, Praia Norte,17,CL,2004-2008,3,4,7
171840, Presidente Kennedy,17,CL,2004-2008,2,20,22
171845, Pugmil,17,CL,2004-2008,2,2,4
171850, Recursolândia,17,CL,2004-2008,6,10,16
171855, Riachinho,17,CL,2004-2008,15,9,24
171865, Rio da Conceição,17,CL,2004-2008,2,5,7
171870, Rio dos Bois,17,CL,2004-2008,4,2,6
171875, Rio Sono,17,CL,2004-2008,12,3,15
171880, Sampaio,17,CL,2004-2008,0,2,2
171884, Sandolândia,17,CL,2004-2008,23,31,54
171886, Santa Fé do Araguaia,17,CL,2004-2008,6,12,18
171888, Santa Maria do Tocantins,17,CL,2004-2008,7,7,14
171889, Santa Rita do Tocantins,17,CL,2004-2008,1,1,2
171890, Santa Rosa do Tocantins,17,CL,2004-2008,6,1,7
172000, Santa Terezinha do Tocantins,17,CL,2004-2008,2,3,5
172010, São Bento do Tocantins,17,CL,2004-2008,8,3,11
172015, São Félix do Tocantins,17,CL,2004-2008,0,1,1
172020, São Miguel do Tocantins,17,CL,2004-2008,2,7,9
172025, São Salvador do Tocantins,17,CL,2004-2008,6,5,11
172030, São Sebastião do Tocantins,17,CL,2004-2008,0,2,2
172049, São Valério,17,CL,2004-2008,0,1,1
172065, Silvanópolis,17,CL,2004-2008,2,4,6
172080, Sítio Novo do Tocantins,17,CL,2004-2008,10,17,27
172090, Taguatinga,17,CL,2004-2008,16,26,42
172110, Tocantínia,17,CL,2004-2008,61,26,87
172120, Tocantinópolis,17,CL,2004-2008,11,32,43
172125, Tupirama,17,CL,2004-2008,2,3,5
172130, Tupiratins,17,CL,2004-2008,3,2,5
172208, Wanderlândia,17,CL,2004-2008,13,15,28
172210, Xambioá,17,CL,2004-2008,10,45,55
210005, Açailândia,21,CL,2004-2008,85,400,485
210020, Alcântara,21,CL,2004-2008,38,12,50
210040, Altamira do Maranhão,21,CL,2004-2008,16,24,40
210043, Alto Alegre do Maranhão,21,CL,2004-2008,35,71,106
210047, Alto Alegre do Pindaré,21,CL,2004-2008,111,18,129
210050, Alto Parnaíba,21,CL,2004-2008,6,7,13
210055, Amapá do Maranhão,21,CL,2004-2008,11,16,27
210060, Amarante do Maranhão,21,CL,2004-2008,95,54,149
210070, Anajatuba,21,CL,2004-2008,8,4,12
210087, Araguanã,21,CL,2004-2008,19,17,36
210095, Arame,21,CL,2004-2008,107,80,187
210110, Axixá,21,CL,2004-2008,91,10,101
210120, Bacabal,21,CL,2004-2008,1,13,14
210125, Bacabeira,21,CL,2004-2008,2,3,5
210130, Bacuri,21,CL,2004-2008,3,1,4
210135, Bacurituba,21,CL,2004-2008,0,1,1
210140, Balsas,21,CL,2004-2008,42,132,174
210160, Barra do Corda,21,CL,2004-2008,63,75,138
210170, Barreirinhas,21,CL,2004-2008,4,1,5
210177, Bela Vista do Maranhão,21,CL,2004-2008,12,6,18
210180, Benedito Leite,21,CL,2004-2008,6,3,9
210190, Bequimão,21,CL,2004-2008,11,1,12
210193, Bernardo do Mearim,21,CL,2004-2008,5,6,11
210197, Boa Vista do Gurupi,21,CL,2004-2008,2,9,11
210200, Bom Jardim,21,CL,2004-2008,84,35,119
210203, Bom Jesus das Selvas,21,CL,2004-2008,94,65,159
210207, Bom Lugar,21,CL,2004-2008,3,1,4
210210, Brejo,21,CL,2004-2008,1,0,1
210215, Brejo de Areia,21,CL,2004-2008,118,42,160
210220, Buriti,21,CL,2004-2008,1,0,1
210230, Buriti Bravo,21,CL,2004-2008,21,84,105
210232, Buriticupu,21,CL,2004-2008,257,263,520
210235, Buritirana,21,CL,2004-2008,20,31,51
210237, Cachoeira Grande,21,CL,2004-2008,23,10,33
210255, Campestre do Maranhão,21,CL,2004-2008,1,8,9
210260, Cândido Mendes,21,CL,2004-2008,41,44,85
210270, Cantanhede,21,CL,2004-2008,14,19,33
210275, Capinzal do Norte,21,CL,2004-2008,3,1,4
210280, Carolina,21,CL,2004-2008,25,28,53
210290, Carutapera,21,CL,2004-2008,28,27,55
210300, Caxias,21,CL,2004-2008,1,1,2
210310, Cedral,21,CL,2004-2008,37,5,42
210312, Central do Maranhão,21,CL,2004-2008,2,2,4
210315, Centro do Guilherme,21,CL,2004-2008,34,32,66
210317, Centro Novo do Maranhão,21,CL,2004-2008,64,21,85
210320, Chapadinha,21,CL,2004-2008,1,0,1
210325, Cidelândia,21,CL,2004-2008,20,17,37
210330, Codó,21,CL,2004-2008,80,92,172
210350, Colinas,21,CL,2004-2008,97,86,183
210360, Coroatá,21,CL,2004-2008,21,34,55
210370, Cururupu,21,CL,2004-2008,4,12,16
210375, Davinópolis,21,CL,2004-2008,8,13,21
210380, Dom Pedro,21,CL,2004-2008,17,26,43
210400, Esperantinópolis,21,CL,2004-2008,35,12,47
210405, Estreito,21,CL,2004-2008,15,20,35
210407, Feira Nova do Maranhão,21,CL,2004-2008,16,2,18
210408, Fernando Falcão,21,CL,2004-2008,17,3,20
210409, Formosa da Serra Negra,21,CL,2004-2008,47,12,59
210410, Fortaleza dos Nogueiras,21,CL,2004-2008,12,18,30
210420, Fortuna,21,CL,2004-2008,78,36,114
210430, Godofredo Viana,21,CL,2004-2008,7,21,28
210440, Gonçalves Dias,21,CL,2004-2008,48,20,68
210450, Governador Archer,21,CL,2004-2008,10,8,18
210455, Governador Edison Lobão,21,CL,2004-2008,10,8,18
210460, Governador Eugênio Barros,21,CL,2004-2008,75,14,89
210462, Governador Luiz Rocha,21,CL,2004-2008,14,13,27
210465, Governador Newton Bello,21,CL,2004-2008,31,14,45
210467, Governador Nunes Freire,21,CL,2004-2008,94,154,248
210470, Graça Aranha,21,CL,2004-2008,5,0,5
210480, Grajaú,21,CL,2004-2008,83,61,144
210490, Guimarães,21,CL,2004-2008,36,29,65
210500, Humberto de Campos,21,CL,2004-2008,4,0,4
210510, Icatu,21,CL,2004-2008,46,4,50
210515, Igarapé do Meio,21,CL,2004-2008,3,3,6
210520, Igarapé Grande,21,CL,2004-2008,7,4,11
210530, Imperatriz,21,CL,2004-2008,8,332,340
210535, Itaipava do Grajaú,21,CL,2004-2008,16,9,25
210540, Itapecuru Mirim,21,CL,2004-2008,58,54,112
210542, Itinga do Maranhão,21,CL,2004-2008,75,222,297
210545, Jatobá,21,CL,2004-2008,14,16,30
210547, Jenipapo dos Vieiras,21,CL,2004-2008,7,4,11
210550, João Lisboa,21,CL,2004-2008,12,49,61
210560, Joselândia,21,CL,2004-2008,38,15,53
210565, Junco do Maranhão,21,CL,2004-2008,15,5,20
210570, Lago da Pedra,21,CL,2004-2008,34,69,103
210580, Lago do Junco,21,CL,2004-2008,8,15,23
210594, Lago dos Rodrigues,21,CL,2004-2008,2,4,6
210590, Lago Verde,21,CL,2004-2008,2,0,2
210592, Lagoa do Mato,21,CL,2004-2008,3,0,3
210596, Lagoa Grande do Maranhão,21,CL,2004-2008,25,17,42
210598, Lajeado Novo,21,CL,2004-2008,9,5,14
210600, Lima Campos,21,CL,2004-2008,8,4,12
210610, Loreto,21,CL,2004-2008,3,2,5
210620, Luís Domingues,21,CL,2004-2008,10,50,60
210630, Magalhães de Almeida,21,CL,2004-2008,1,1,2
210632, Maracaçumé,21,CL,2004-2008,3,79,82
210635, Marajá do Sena,21,CL,2004-2008,69,9,78
210637, Maranhãozinho,21,CL,2004-2008,11,50,61
210640, Mata Roma,21,CL,2004-2008,0,1,1
210650, Matinha,21,CL,2004-2008,1,1,2
210663, Matões do Norte,21,CL,2004-2008,2,1,3
210670, Mirador,21,CL,2004-2008,77,42,119
210675, Miranda do Norte,21,CL,2004-2008,5,19,24
210680, Mirinzal,21,CL,2004-2008,10,15,25
210690, Monção,21,CL,2004-2008,4,1,5
210700, Montes Altos,21,CL,2004-2008,39,34,73
210710, Morros,21,CL,2004-2008,45,15,60
210725, Nova Colinas,21,CL,2004-2008,6,3,9
210730, Nova Iorque,21,CL,2004-2008,4,0,4
210735, Nova Olinda do Maranhão,21,CL,2004-2008,9,8,17
210740, Olho d'Água das Cunhãs,21,CL,2004-2008,7,5,12
210745, Olinda Nova do Maranhão,21,CL,2004-2008,4,3,7
210750, Paço do Lumiar,21,CL,2004-2008,9,2,11
210760, Palmeirândia,21,CL,2004-2008,22,2,24
210770, Paraibano,21,CL,2004-2008,26,70,96
210800, Pastos Bons,21,CL,2004-2008,20,24,44
210810, Paulo Ramos,21,CL,2004-2008,131,84,215
210820, Pedreiras,21,CL,2004-2008,4,30,34
210825, Pedro do Rosário,21,CL,2004-2008,36,6,42
210830, Penalva,21,CL,2004-2008,3,6,9
210840, Peri Mirim,21,CL,2004-2008,2,1,3
210845, Peritoró,21,CL,2004-2008,12,8,20
210850, Pindaré-Mirim,21,CL,2004-2008,9,24,33
210860, Pinheiro,21,CL,2004-2008,34,41,75
210870, Pio XII,21,CL,2004-2008,6,9,15
210880, Pirapemas,21,CL,2004-2008,10,2,12
210890, Poção de Pedras,21,CL,2004-2008,39,8,47
210900, Porto Franco,21,CL,2004-2008,12,17,29
210905, Porto Rico do Maranhão,21,CL,2004-2008,27,1,28
210910, Presidente Dutra,21,CL,2004-2008,16,47,63
210920, Presidente Juscelino,21,CL,2004-2008,18,10,28
210923, Presidente Médici,21,CL,2004-2008,8,21,29
210927, Presidente Sarney,21,CL,2004-2008,11,3,14
210930, Presidente Vargas,21,CL,2004-2008,25,16,41
210940, Primeira Cruz,21,CL,2004-2008,1,0,1
210945, Raposa,21,CL,2004-2008,1,1,2
210950, Riachão,21,CL,2004-2008,31,43,74
210955, Ribamar Fiquene,21,CL,2004-2008,8,4,12
210960, Rosário,21,CL,2004-2008,46,34,80
210970, Sambaíba,21,CL,2004-2008,4,4,8
210975, Santa Filomena do Maranhão,21,CL,2004-2008,6,3,9
210980, Santa Helena,21,CL,2004-2008,8,16,24
210990, Santa Inês,21,CL,2004-2008,10,52,62
211000, Santa Luzia,21,CL,2004-2008,328,67,395
211003, Santa Luzia do Paruá,21,CL,2004-2008,30,33,63
211020, Santa Rita,21,CL,2004-2008,10,5,15
211027, Santo Amaro do Maranhão,21,CL,2004-2008,0,1,1
211030, Santo Antônio dos Lopes,21,CL,2004-2008,20,18,38
211050, São Bento,21,CL,2004-2008,2,5,7
211065, São Domingos do Azeitão,21,CL,2004-2008,5,12,17
211070, São Domingos do Maranhão,21,CL,2004-2008,90,97,187
211080, São Félix de Balsas,21,CL,2004-2008,13,2,15
211085, São Francisco do Brejão,21,CL,2004-2008,4,18,22
211102, São João do Carú,21,CL,2004-2008,91,26,117
211105, São João do Paraíso,21,CL,2004-2008,7,2,9
211107, São João do Soter,21,CL,2004-2008,19,17,36
211120, São José de Ribamar,21,CL,2004-2008,10,7,17
211125, São José dos Basílios,21,CL,2004-2008,7,5,12
211130, São Luís,21,CL,2004-2008,6,103,109
211140, São Luís Gonzaga do Maranhão,21,CL,2004-2008,27,13,40
211150, São Mateus do Maranhão,21,CL,2004-2008,2,1,3
211153, São Pedro da Água Branca,21,CL,2004-2008,0,29,29
211157, São Pedro dos Crentes,21,CL,2004-2008,4,3,7
211160, São Raimundo das Mangabeiras,21,CL,2004-2008,9,16,25
211163, São Raimundo do Doca Bezerra,21,CL,2004-2008,4,1,5
211167, São Roberto,21,CL,2004-2008,14,6,20
211172, Satubinha,21,CL,2004-2008,3,0,3
211174, Senador Alexandre Costa,21,CL,2004-2008,12,18,30
211176, Senador La Rocque,21,CL,2004-2008,34,43,77
211178, Serrano do Maranhão,21,CL,2004-2008,4,0,4
211180, Sítio Novo,21,CL,2004-2008,33,14,47
211190, Sucupira do Norte,21,CL,2004-2008,35,32,67
211200, Tasso Fragoso,21,CL,2004-2008,2,1,3
211210, Timbiras,21,CL,2004-2008,11,25,36
211223, Trizidela do Vale,21,CL,2004-2008,8,31,39
211227, Tufilândia,21,CL,2004-2008,10,4,14
211230, Tuntum,21,CL,2004-2008,18,15,33
211240, Turiaçu,21,CL,2004-2008,111,20,131
211245, Turilândia,21,CL,2004-2008,30,16,46
211260, Urbano Santos,21,CL,2004-2008,1,1,2
211270, Vargem Grande,21,CL,2004-2008,33,43,76
211280, Viana,21,CL,2004-2008,16,5,21
211285, Vila Nova dos Martírios,21,CL,2004-2008,2,12,14
211290, Vitória do Mearim,21,CL,2004-2008,10,4,14
211300, Vitorino Freire,21,CL,2004-2008,35,55,90
211400, Zé Doca,21,CL,2004-2008,110,84,194
231340, Tianguá,23,CL,2004-2008,1,0,1
250400, Campina Grande,25,CL,2004-2008,0,1,1
261040, Parnamirim,26,CL,2004-2008,1,0,1
310550, Barão de Monte Alto,31,CL,2004-2008,1,0,1
330455, Rio de Janeiro,33,CL,2004-2008,NA,NA,1
351000, Cândido Mota,35,CL,2004-2008,0,1,1
352940, Mauá,35,CL,2004-2008,0,1,1
353280, Nova Aliança,35,CL,2004-2008,0,1,1
355030, São Paulo,35,CL,2004-2008,0,2,2
410210, Astorga,41,CL,2004-2008,0,1,1
410785, Flor da Serra do Sul,41,CL,2004-2008,0,1,1
411790, Palotina,41,CL,2004-2008,0,1,1
420470, Cunha Porã,42,CL,2004-2008,0,1,1
420690, Ibirama,42,CL,2004-2008,0,1,1
421720, São Miguel do Oeste,42,CL,2004-2008,0,1,1
421820, Timbó,42,CL,2004-2008,NA,NA,1
431340, Novo Hamburgo,43,CL,2004-2008,NA,NA,1
500270, Campo Grande,50,CL,2004-2008,0,1,1
500330, Coxim,50,CL,2004-2008,0,1,1
510010, Acorizal,51,CL,2004-2008,4,5,9
510020, Água Boa,51,CL,2004-2008,25,34,59
510025, Alta Floresta,51,CL,2004-2008,100,250,350
510030, Alto Araguaia,51,CL,2004-2008,18,43,61
510035, Alto Boa Vista,51,CL,2004-2008,55,67,122
510040, Alto Garças,51,CL,2004-2008,0,7,7
510050, Alto Paraguai,51,CL,2004-2008,14,44,58
510060, Alto Taquari,51,CL,2004-2008,3,19,22
510080, Apiacás,51,CL,2004-2008,28,46,74
510100, Araguaiana,51,CL,2004-2008,8,19,27
510120, Araguainha,51,CL,2004-2008,2,6,8
510125, Araputanga,51,CL,2004-2008,30,28,58
510130, Arenápolis,51,CL,2004-2008,10,83,93
510140, Aripuanã,51,CL,2004-2008,123,164,287
510170, Barra do Bugres,51,CL,2004-2008,35,79,114
510180, Barra do Garças,51,CL,2004-2008,48,164,212
510185, Bom Jesus do Araguaia,51,CL,2004-2008,78,25,103
510190, Brasnorte,51,CL,2004-2008,181,158,339
510250, Cáceres,51,CL,2004-2008,46,85,131
510260, Campinápolis,51,CL,2004-2008,169,54,223
510263, Campo Novo do Parecis,51,CL,2004-2008,71,100,171
510267, Campo Verde,51,CL,2004-2008,68,64,132
510268, Campos de Júlio,51,CL,2004-2008,16,20,36
510269, Canabrava do Norte,51,CL,2004-2008,77,115,192
510270, Canarana,51,CL,2004-2008,85,69,154
510279, Carlinda,51,CL,2004-2008,71,37,108
510285, Castanheira,51,CL,2004-2008,91,55,146
510300, Chapada dos Guimarães,51,CL,2004-2008,42,16,58
510305, Cláudia,51,CL,2004-2008,46,170,216
510310, Cocalinho,51,CL,2004-2008,6,1,7
510320, Colíder,51,CL,2004-2008,52,104,156
510325, Colniza,51,CL,2004-2008,441,217,658
510330, Comodoro,51,CL,2004-2008,116,112,228
510335, Confresa,51,CL,2004-2008,83,56,139
510336, Conquista D'Oeste,51,CL,2004-2008,12,7,19
510337, Cotriguaçu,51,CL,2004-2008,271,109,380
510340, Cuiabá,51,CL,2004-2008,11,210,221
510343, Curvelândia,51,CL,2004-2008,10,3,13
510345, Denise,51,CL,2004-2008,8,7,15
510350, Diamantino,51,CL,2004-2008,61,78,139
510360, Dom Aquino,51,CL,2004-2008,4,24,28
510370, Feliz Natal,51,CL,2004-2008,143,205,348
510380, Figueirópolis D'Oeste,51,CL,2004-2008,6,5,11
510385, Gaúcha do Norte,51,CL,2004-2008,39,26,65
510390, General Carneiro,51,CL,2004-2008,68,66,134
510395, Glória D'Oeste,51,CL,2004-2008,0,5,5
510410, Guarantã do Norte,51,CL,2004-2008,144,227,371
510420, Guiratinga,51,CL,2004-2008,18,38,56
510450, Indiavaí,51,CL,2004-2008,4,4,8
510452, Ipiranga do Norte,51,CL,2004-2008,11,16,27
510454, Itanhangá,51,CL,2004-2008,17,20,37
510455, Itaúba,51,CL,2004-2008,59,125,184
510460, Itiquira,51,CL,2004-2008,23,13,36
510480, Jaciara,51,CL,2004-2008,5,29,34
510490, Jangada,51,CL,2004-2008,24,5,29
510500, Jauru,51,CL,2004-2008,5,14,19
510510, Juara,51,CL,2004-2008,119,213,332
510515, Juína,51,CL,2004-2008,188,365,553
510517, Juruena,51,CL,2004-2008,160,107,267
510520, Juscimeira,51,CL,2004-2008,21,11,32
510523, Lambari D'Oeste,51,CL,2004-2008,8,3,11
510525, Lucas do Rio Verde,51,CL,2004-2008,62,212,274
510530, Luciara,51,CL,2004-2008,0,3,3
510558, Marcelândia,51,CL,2004-2008,90,235,325
510560, Matupá,51,CL,2004-2008,57,94,151
510562, Mirassol d'Oeste,51,CL,2004-2008,11,28,39
510590, Nobres,51,CL,2004-2008,38,43,81
510600, Nortelândia,51,CL,2004-2008,20,38,58
510610, Nossa Senhora do Livramento,51,CL,2004-2008,26,4,30
510615, Nova Bandeirantes,51,CL,2004-2008,123,45,168
510620, Nova Brasilândia,51,CL,2004-2008,31,21,52
510621, Nova Canaã do Norte,51,CL,2004-2008,69,79,148
510880, Nova Guarita,51,CL,2004-2008,18,13,31
510618, Nova Lacerda,51,CL,2004-2008,32,20,52
510885, Nova Marilândia,51,CL,2004-2008,34,36,70
510890, Nova Maringá,51,CL,2004-2008,100,181,281
510895, Nova Monte Verde,51,CL,2004-2008,35,31,66
510622, Nova Mutum,51,CL,2004-2008,121,84,205
510617, Nova Nazaré,51,CL,2004-2008,2,1,3
510623, Nova Olímpia,51,CL,2004-2008,19,40,59
510619, Nova Santa Helena,51,CL,2004-2008,18,21,39
510624, Nova Ubiratã,51,CL,2004-2008,211,94,305
510625, Nova Xavantina,51,CL,2004-2008,21,59,80
510627, Novo Horizonte do Norte,51,CL,2004-2008,35,32,67
510626, Novo Mundo,51,CL,2004-2008,50,17,67
510631, Novo Santo Antônio,51,CL,2004-2008,3,4,7
510628, Novo São Joaquim,51,CL,2004-2008,18,38,56
510629, Paranaíta,51,CL,2004-2008,42,34,76
510630, Paranatinga,51,CL,2004-2008,160,105,265
510637, Pedra Preta,51,CL,2004-2008,17,24,41
510642, Peixoto de Azevedo,51,CL,2004-2008,187,171,358
510645, Planalto da Serra,51,CL,2004-2008,1,6,7
510650, Poconé,51,CL,2004-2008,14,10,24
510665, Pontal do Araguaia,51,CL,2004-2008,14,30,44
510670, Ponte Branca,51,CL,2004-2008,3,12,15
510675, Pontes e Lacerda,51,CL,2004-2008,38,65,103
510677, Porto Alegre do Norte,51,CL,2004-2008,12,44,56
510680, Porto dos Gaúchos,51,CL,2004-2008,53,70,123
510682, Porto Esperidião,51,CL,2004-2008,10,5,15
510685, Porto Estrela,51,CL,2004-2008,6,6,12
510700, Poxoréo,51,CL,2004-2008,45,72,117
510704, Primavera do Leste,51,CL,2004-2008,46,226,272
510706, Querência,51,CL,2004-2008,13,23,36
510715, Reserva do Cabaçal,51,CL,2004-2008,9,11,20
510718, Ribeirão Cascalheira,51,CL,2004-2008,20,33,53
510719, Ribeirãozinho,51,CL,2004-2008,4,15,19
510720, Rio Branco,51,CL,2004-2008,0,1,1
510757, Rondolândia,51,CL,2004-2008,26,4,30
510760, Rondonópolis,51,CL,2004-2008,34,182,216
510770, Rosário Oeste,51,CL,2004-2008,23,23,46
510775, Salto do Céu,51,CL,2004-2008,11,3,14
510724, Santa Carmem,51,CL,2004-2008,22,82,104
510774, Santa Cruz do Xingu,51,CL,2004-2008,10,12,22
510776, Santa Rita do Trivelato,51,CL,2004-2008,36,21,57
510777, Santa Terezinha,51,CL,2004-2008,30,6,36
510726, Santo Afonso,51,CL,2004-2008,28,19,47
510779, Santo Antônio do Leste,51,CL,2004-2008,12,6,18
510780, Santo Antônio do Leverger,51,CL,2004-2008,14,5,19
510785, São Félix do Araguaia,51,CL,2004-2008,51,16,67
510729, São José do Povo,51,CL,2004-2008,8,2,10
510730, São José do Rio Claro,51,CL,2004-2008,111,220,331
510735, São José do Xingu,51,CL,2004-2008,14,31,45
510710, São José dos Quatro Marcos,51,CL,2004-2008,1,9,10
510740, São Pedro da Cipa,51,CL,2004-2008,1,3,4
510787, Sapezal,51,CL,2004-2008,32,50,82
510788, Serra Nova Dourada,51,CL,2004-2008,39,37,76
510790, Sinop,51,CL,2004-2008,166,816,982
510792, Sorriso,51,CL,2004-2008,157,387,544
510794, Tabaporã,51,CL,2004-2008,59,43,102
510795, Tangará da Serra,51,CL,2004-2008,60,235,295
510800, Tapurah,51,CL,2004-2008,83,162,245
510805, Terra Nova do Norte,51,CL,2004-2008,62,59,121
510810, Tesouro,51,CL,2004-2008,5,21,26
510820, Torixoréu,51,CL,2004-2008,7,11,18
510830, União do Sul,51,CL,2004-2008,45,48,93
510835, Vale de São Domingos,51,CL,2004-2008,3,2,5
510840, Várzea Grande,51,CL,2004-2008,2,113,115
510850, Vera,51,CL,2004-2008,71,177,248
510550, Vila Bela da Santíssima Trindade,51,CL,2004-2008,14,7,21
510860, Vila Rica,51,CL,2004-2008,44,54,98
520170, Aragarças,52,CL,2004-2008,1,3,4
520725, Doverlândia,52,CL,2004-2008,4,0,4
520870, Goiânia,52,CL,2004-2008,1,2,3
521220, Jussara,52,CL,2004-2008,0,1,1
521405, Mundo Novo,52,CL,2004-2008,1,0,1
150410, Magalhães Barata,15,CL,2004-2008,4,0,4
150570, Ponta de Pedras,15,CL,2004-2008,1,0,1
150635, Santa Bárbara do Pará,15,CL,2004-2008,1,1,2
160025, Itaubal,16,CL,2004-2008,3,0,3
170765, Figueirópolis,17,CL,2004-2008,0,1,1
170980, Ipueiras,17,CL,2004-2008,3,0,3
171180, Juarina,17,CL,2004-2008,0,1,1
171195, Lagoa do Tocantins,17,CL,2004-2008,1,0,1
171900, Santa Tereza do Tocantins,17,CL,2004-2008,1,4,5
172093, Taipas do Tocantins,17,CL,2004-2008,0,1,1
172097, Talismã,17,CL,2004-2008,1,0,1
210100, Arari,21,CL,2004-2008,0,1,1
211100, São João Batista,21,CL,2004-2008,0,1,1
211170, São Vicente Ferrer,21,CL,2004-2008,0,1,1
211220, Timon,21,CL,2004-2008,0,1,1
230410, Crateús,23,CL,2004-2008,0,1,1
251390, São Bento,25,CL,2004-2008,NA,NA,1
310620, Belo Horizonte,31,CL,2004-2008,0,1,1
355430, Teodoro Sampaio,35,CL,2004-2008,0,1,1
410050, Altônia,41,CL,2004-2008,0,1,1
410150, Arapongas,41,CL,2004-2008,0,1,1
420460, Criciúma,42,CL,2004-2008,0,1,1
430510, Caxias do Sul,43,CL,2004-2008,0,1,1
431560, Rio Grande,43,CL,2004-2008,0,1,1
521375, Montividiu,52,CL,2004-2008,0,1,1
110001, Alta Floresta D'Oeste,11,CL,2015-2019,76,30,106
110037, Alto Alegre dos Parecis,11,CL,2015-2019,86,31,117
110040, Alto Paraíso,11,CL,2015-2019,34,19,53
110034, Alvorada D'Oeste,11,CL,2015-2019,19,19,38
110002, Ariquemes,11,CL,2015-2019,62,175,237
110045, Buritis,11,CL,2015-2019,47,38,85
110003, Cabixi,11,CL,2015-2019,14,8,22
110060, Cacaulândia,11,CL,2015-2019,14,11,25
110004, Cacoal,11,CL,2015-2019,88,125,213
110070, Campo Novo de Rondônia,11,CL,2015-2019,52,22,74
110080, Candeias do Jamari,11,CL,2015-2019,45,22,67
110090, Castanheiras,11,CL,2015-2019,18,15,33
110005, Cerejeiras,11,CL,2015-2019,11,33,44
110092, Chupinguaia,11,CL,2015-2019,69,49,118
110006, Colorado do Oeste,11,CL,2015-2019,19,30,49
110007, Corumbiara,11,CL,2015-2019,43,12,55
110008, Costa Marques,11,CL,2015-2019,67,54,121
110094, Cujubim,11,CL,2015-2019,59,77,136
110009, Espigão D'Oeste,11,CL,2015-2019,139,105,244
110100, Governador Jorge Teixeira,11,CL,2015-2019,43,4,47
110010, Guajará-Mirim,11,CL,2015-2019,36,52,88
110110, Itapuã do Oeste,11,CL,2015-2019,6,7,13
110011, Jaru,11,CL,2015-2019,43,41,84
110012, Ji-Paraná,11,CL,2015-2019,65,140,205
110013, Machadinho D'Oeste,11,CL,2015-2019,119,93,212
110120, Ministro Andreazza,11,CL,2015-2019,17,9,26
110130, Mirante da Serra,11,CL,2015-2019,25,11,36
110140, Monte Negro,11,CL,2015-2019,45,11,56
110014, Nova Brasilândia D'Oeste,11,CL,2015-2019,38,7,45
110033, Nova Mamoré,11,CL,2015-2019,106,19,125
110143, Nova União,11,CL,2015-2019,11,1,12
110050, Novo Horizonte do Oeste,11,CL,2015-2019,29,3,32
110015, Ouro Preto do Oeste,11,CL,2015-2019,18,21,39
110145, Parecis,11,CL,2015-2019,50,15,65
110018, Pimenta Bueno,11,CL,2015-2019,95,151,246
110146, Pimenteiras do Oeste,11,CL,2015-2019,3,2,5
110020, Porto Velho,11,CL,2015-2019,273,440,713
110025, Presidente Médici,11,CL,2015-2019,21,18,39
110147, Primavera de Rondônia,11,CL,2015-2019,8,2,10
110026, Rio Crespo,11,CL,2015-2019,16,2,18
110028, Rolim de Moura,11,CL,2015-2019,43,214,257
110029, Santa Luzia D'Oeste,11,CL,2015-2019,28,19,47
110148, São Felipe D'Oeste,11,CL,2015-2019,10,8,18
110149, São Francisco do Guaporé,11,CL,2015-2019,94,54,148
110032, São Miguel do Guaporé,11,CL,2015-2019,86,18,104
110150, Seringueiras,11,CL,2015-2019,30,9,39
110155, Teixeirópolis,11,CL,2015-2019,6,0,6
110160, Theobroma,11,CL,2015-2019,18,6,24
110170, Urupá,11,CL,2015-2019,10,4,14
110175, Vale do Anari,11,CL,2015-2019,17,5,22
110180, Vale do Paraíso,11,CL,2015-2019,20,8,28
110030, Vilhena,11,CL,2015-2019,116,323,439
110000, Município ignorado - RO,11,CL,2015-2019,1,0,1
120001, Acrelândia,12,CL,2015-2019,44,27,71
120005, Assis Brasil,12,CL,2015-2019,248,145,393
120010, Brasiléia,12,CL,2015-2019,241,140,381
120013, Bujari,12,CL,2015-2019,85,20,105
120017, Capixaba,12,CL,2015-2019,162,56,218
120020, Cruzeiro do Sul,12,CL,2015-2019,121,145,266
120025, Epitaciolândia,12,CL,2015-2019,90,143,233
120030, Feijó,12,CL,2015-2019,198,72,270
120032, Jordão,12,CL,2015-2019,48,23,71
120033, Mâncio Lima,12,CL,2015-2019,110,65,175
120034, Manoel Urbano,12,CL,2015-2019,97,49,146
120035, Marechal Thaumaturgo,12,CL,2015-2019,153,37,190
120038, Plácido de Castro,12,CL,2015-2019,38,151,189
120080, Porto Acre,12,CL,2015-2019,49,25,74
120039, Porto Walter,12,CL,2015-2019,40,23,63
120040, Rio Branco,12,CL,2015-2019,337,700,1037
120042, Rodrigues Alves,12,CL,2015-2019,34,17,51
120043, Santa Rosa do Purus,12,CL,2015-2019,44,46,90
120050, Sena Madureira,12,CL,2015-2019,362,133,495
120045, Senador Guiomard,12,CL,2015-2019,33,41,74
120060, Tarauacá,12,CL,2015-2019,63,30,93
120070, Xapuri,12,CL,2015-2019,452,6,458
120000, Município ignorado - AC,12,CL,2015-2019,0,1,1
130002, Alvarães,13,CL,2015-2019,0,5,5
130006, Amaturá,13,CL,2015-2019,2,3,5
130008, Anamã,13,CL,2015-2019,6,1,7
130010, Anori,13,CL,2015-2019,0,6,6
130014, Apuí,13,CL,2015-2019,48,50,98
130020, Atalaia do Norte,13,CL,2015-2019,43,33,76
130030, Autazes,13,CL,2015-2019,51,32,83
130040, Barcelos,13,CL,2015-2019,30,53,83
130050, Barreirinha,13,CL,2015-2019,68,15,83
130060, Benjamin Constant,13,CL,2015-2019,4,14,18
130063, Beruri,13,CL,2015-2019,2,1,3
130068, Boa Vista do Ramos,13,CL,2015-2019,10,6,16
130070, Boca do Acre,13,CL,2015-2019,146,102,248
130080, Borba,13,CL,2015-2019,51,5,56
130083, Caapiranga,13,CL,2015-2019,14,10,24
130090, Canutama,13,CL,2015-2019,29,11,40
130100, Carauari,13,CL,2015-2019,9,45,54
130110, Careiro,13,CL,2015-2019,17,7,24
130115, Careiro da Várzea,13,CL,2015-2019,4,1,5
130120, Coari,13,CL,2015-2019,9,22,31
130130, Codajás,13,CL,2015-2019,1,3,4
130140, Eirunepé,13,CL,2015-2019,70,67,137
130150, Envira,13,CL,2015-2019,40,130,170
130160, Fonte Boa,13,CL,2015-2019,4,1,5
130165, Guajará,13,CL,2015-2019,27,23,50
130170, Humaitá,13,CL,2015-2019,108,90,198
130180, Ipixuna,13,CL,2015-2019,32,22,54
130185, Iranduba,13,CL,2015-2019,21,6,27
130190, Itacoatiara,13,CL,2015-2019,308,78,386
130195, Itamarati,13,CL,2015-2019,4,3,7
130200, Itapiranga,13,CL,2015-2019,5,12,17
130210, Japurá,13,CL,2015-2019,6,7,13
130220, Juruá,13,CL,2015-2019,1,4,5
130230, Jutaí,13,CL,2015-2019,2,3,5
130240, Lábrea,13,CL,2015-2019,53,131,184
130250, Manacapuru,13,CL,2015-2019,53,46,99
130255, Manaquiri,13,CL,2015-2019,1,1,2
130260, Manaus,13,CL,2015-2019,912,1389,2301
130270, Manicoré,13,CL,2015-2019,108,40,148
130280, Maraã,13,CL,2015-2019,3,4,7
130290, Maués,13,CL,2015-2019,81,52,133
130300, Nhamundá,13,CL,2015-2019,46,35,81
130310, Nova Olinda do Norte,13,CL,2015-2019,22,23,45
130320, Novo Airão,13,CL,2015-2019,32,27,59
130330, Novo Aripuanã,13,CL,2015-2019,33,52,85
130340, Parintins,13,CL,2015-2019,37,25,62
130350, Pauini,13,CL,2015-2019,56,59,115
130353, Presidente Figueiredo,13,CL,2015-2019,811,169,980
130356, Rio Preto da Eva,13,CL,2015-2019,864,92,956
130360, Santa Isabel do Rio Negro,13,CL,2015-2019,34,19,53
130370, Santo Antônio do Içá,13,CL,2015-2019,3,6,9
130380, São Gabriel da Cachoeira,13,CL,2015-2019,31,99,130
130390, São Paulo de Olivença,13,CL,2015-2019,3,9,12
130395, São Sebastião do Uatumã,13,CL,2015-2019,9,5,14
130400, Silves,13,CL,2015-2019,43,7,50
130406, Tabatinga,13,CL,2015-2019,3,20,23
130410, Tapauá,13,CL,2015-2019,17,22,39
130420, Tefé,13,CL,2015-2019,12,14,26
130423, Tonantins,13,CL,2015-2019,5,15,20
130426, Uarini,13,CL,2015-2019,3,11,14
130430, Urucará,13,CL,2015-2019,8,10,18
130440, Urucurituba,13,CL,2015-2019,2,3,5
140005, Alto Alegre,14,CL,2015-2019,96,11,107
140002, Amajari,14,CL,2015-2019,66,4,70
140010, Boa Vista,14,CL,2015-2019,9,415,424
140015, Bonfim,14,CL,2015-2019,6,5,11
140017, Cantá,14,CL,2015-2019,26,15,41
140020, Caracaraí,14,CL,2015-2019,22,22,44
140023, Caroebe,14,CL,2015-2019,134,87,221
140028, Iracema,14,CL,2015-2019,17,21,38
140030, Mucajaí,14,CL,2015-2019,15,9,24
140045, Pacaraima,14,CL,2015-2019,37,90,127
140047, Rorainópolis,14,CL,2015-2019,68,75,143
140050, São João da Baliza,14,CL,2015-2019,37,42,79
140060, São Luiz,14,CL,2015-2019,16,14,30
140070, Uiramutã,14,CL,2015-2019,58,10,68
140000, Município ignorado - RR,14,CL,2015-2019,1,0,1
150010, Abaetetuba,15,CL,2015-2019,15,6,21
150013, Abel Figueiredo,15,CL,2015-2019,12,33,45
150020, Acará,15,CL,2015-2019,29,7,36
150030, Afuá,15,CL,2015-2019,27,1,28
150034, Água Azul do Norte,15,CL,2015-2019,18,19,37
150040, Alenquer,15,CL,2015-2019,133,125,258
150050, Almeirim,15,CL,2015-2019,130,40,170
150060, Altamira,15,CL,2015-2019,173,304,477
150070, Anajás,15,CL,2015-2019,11,1,12
150080, Ananindeua,15,CL,2015-2019,0,17,17
150085, Anapu,15,CL,2015-2019,229,66,295
150090, Augusto Corrêa,15,CL,2015-2019,34,4,38
150095, Aurora do Pará,15,CL,2015-2019,19,6,25
150100, Aveiro,15,CL,2015-2019,46,11,57
150110, Bagre,15,CL,2015-2019,97,22,119
150120, Baião,15,CL,2015-2019,70,5,75
150125, Bannach,15,CL,2015-2019,11,9,20
150130, Barcarena,15,CL,2015-2019,11,8,19
150140, Belém,15,CL,2015-2019,4,31,35
150145, Belterra,15,CL,2015-2019,84,30,114
150150, Benevides,15,CL,2015-2019,0,9,9
150157, Bom Jesus do Tocantins,15,CL,2015-2019,15,21,36
150160, Bonito,15,CL,2015-2019,14,7,21
150170, Bragança,15,CL,2015-2019,109,28,137
150172, Brasil Novo,15,CL,2015-2019,190,84,274
150175, Brejo Grande do Araguaia,15,CL,2015-2019,9,4,13
150178, Breu Branco,15,CL,2015-2019,78,74,152
150180, Breves,15,CL,2015-2019,6,14,20
150190, Bujaru,15,CL,2015-2019,3,2,5
150200, Cachoeira do Arari,15,CL,2015-2019,1,3,4
150195, Cachoeira do Piriá,15,CL,2015-2019,182,23,205
150210, Cametá,15,CL,2015-2019,20,12,32
150215, Canaã dos Carajás,15,CL,2015-2019,14,53,67
150220, Capanema,15,CL,2015-2019,3,19,22
150230, Capitão Poço,15,CL,2015-2019,17,20,37
150240, Castanhal,15,CL,2015-2019,16,28,44
150250, Chaves,15,CL,2015-2019,3,0,3
150260, Colares,15,CL,2015-2019,8,1,9
150270, Conceição do Araguaia,15,CL,2015-2019,9,23,32
150275, Concórdia do Pará,15,CL,2015-2019,9,7,16
150276, Cumaru do Norte,15,CL,2015-2019,21,28,49
150277, Curionópolis,15,CL,2015-2019,38,21,59
150280, Curralinho,15,CL,2015-2019,27,16,43
150285, Curuá,15,CL,2015-2019,12,10,22
150290, Curuçá,15,CL,2015-2019,6,2,8
150293, Dom Eliseu,15,CL,2015-2019,39,87,126
150295, Eldorado do Carajás,15,CL,2015-2019,27,20,47
150300, Faro,15,CL,2015-2019,3,13,16
150304, Floresta do Araguaia,15,CL,2015-2019,9,7,16
150307, Garrafão do Norte,15,CL,2015-2019,48,23,71
150309, Goianésia do Pará,15,CL,2015-2019,115,178,293
150310, Gurupá,15,CL,2015-2019,12,4,16
150320, Igarapé-Açu,15,CL,2015-2019,14,7,21
150330, Igarapé-Miri,15,CL,2015-2019,71,35,106
150340, Inhangapi,15,CL,2015-2019,6,6,12
150345, Ipixuna do Pará,15,CL,2015-2019,83,19,102
150350, Irituia,15,CL,2015-2019,36,5,41
150360, Itaituba,15,CL,2015-2019,309,280,589
150370, Itupiranga,15,CL,2015-2019,109,59,168
150375, Jacareacanga,15,CL,2015-2019,45,53,98
150380, Jacundá,15,CL,2015-2019,22,98,120
150390, Juruti,15,CL,2015-2019,85,60,145
150400, Limoeiro do Ajuru,15,CL,2015-2019,2,0,2
150405, Mãe do Rio,15,CL,2015-2019,10,25,35
150410, Magalhães Barata,15,CL,2015-2019,2,2,4
150420, Marabá,15,CL,2015-2019,171,241,412
150430, Maracanã,15,CL,2015-2019,3,0,3
150440, Marapanim,15,CL,2015-2019,1,0,1
150442, Marituba,15,CL,2015-2019,0,8,8
150445, Medicilândia,15,CL,2015-2019,592,85,677
150450, Melgaço,15,CL,2015-2019,8,1,9
150460, Mocajuba,15,CL,2015-2019,14,8,22
150470, Moju,15,CL,2015-2019,99,15,114
150475, Mojuí dos Campos,15,CL,2015-2019,169,46,215
150480, Monte Alegre,15,CL,2015-2019,413,74,487
150490, Muaná,15,CL,2015-2019,6,3,9
150495, Nova Esperança do Piriá,15,CL,2015-2019,116,78,194
150497, Nova Ipixuna,15,CL,2015-2019,6,16,22
150500, Nova Timboteua,15,CL,2015-2019,6,5,11
150503, Novo Progresso,15,CL,2015-2019,49,164,213
150506, Novo Repartimento,15,CL,2015-2019,362,82,444
150510, Óbidos,15,CL,2015-2019,174,45,219
150520, Oeiras do Pará,15,CL,2015-2019,56,36,92
150530, Oriximiná,15,CL,2015-2019,100,204,304
150540, Ourém,15,CL,2015-2019,8,3,11
150543, Ourilândia do Norte,15,CL,2015-2019,66,86,152
150548, Pacajá,15,CL,2015-2019,178,80,258
150549, Palestina do Pará,15,CL,2015-2019,2,4,6
150550, Paragominas,15,CL,2015-2019,187,200,387
150553, Parauapebas,15,CL,2015-2019,120,384,504
150555, Pau D'Arco,15,CL,2015-2019,5,9,14
150560, Peixe-Boi,15,CL,2015-2019,2,0,2
150563, Piçarra,15,CL,2015-2019,6,4,10
150565, Placas,15,CL,2015-2019,108,50,158
150580, Portel,15,CL,2015-2019,416,172,588
150590, Porto de Moz,15,CL,2015-2019,31,34,65
150600, Prainha,15,CL,2015-2019,216,20,236
150610, Primavera,15,CL,2015-2019,5,3,8
150611, Quatipuru,15,CL,2015-2019,0,2,2
150613, Redenção,15,CL,2015-2019,4,108,112
150616, Rio Maria,15,CL,2015-2019,3,42,45
150618, Rondon do Pará,15,CL,2015-2019,28,153,181
150619, Rurópolis,15,CL,2015-2019,140,92,232
150620, Salinópolis,15,CL,2015-2019,1,12,13
150630, Salvaterra,15,CL,2015-2019,6,2,8
150635, Santa Bárbara do Pará,15,CL,2015-2019,1,0,1
150650, Santa Izabel do Pará,15,CL,2015-2019,4,9,13
150655, Santa Luzia do Pará,15,CL,2015-2019,26,18,44
150658, Santa Maria das Barreiras,15,CL,2015-2019,22,8,30
150660, Santa Maria do Pará,15,CL,2015-2019,18,2,20
150670, Santana do Araguaia,15,CL,2015-2019,17,26,43
150680, Santarém,15,CL,2015-2019,222,262,484
150690, Santarém Novo,15,CL,2015-2019,3,1,4
150700, Santo Antônio do Tauá,15,CL,2015-2019,0,3,3
150710, São Caetano de Odivelas,15,CL,2015-2019,5,3,8
150715, São Domingos do Araguaia,15,CL,2015-2019,34,50,84
150720, São Domingos do Capim,15,CL,2015-2019,18,1,19
150730, São Félix do Xingu,15,CL,2015-2019,235,77,312
150740, São Francisco do Pará,15,CL,2015-2019,15,7,22
150745, São Geraldo do Araguaia,15,CL,2015-2019,39,32,71
150746, São João da Ponta,15,CL,2015-2019,2,1,3
150747, São João de Pirabas,15,CL,2015-2019,3,5,8
150750, São João do Araguaia,15,CL,2015-2019,58,4,62
150760, São Miguel do Guamá,15,CL,2015-2019,0,7,7
150770, São Sebastião da Boa Vista,15,CL,2015-2019,8,1,9
150775, Sapucaia,15,CL,2015-2019,0,4,4
150780, Senador José Porfírio,15,CL,2015-2019,121,43,164
150790, Soure,15,CL,2015-2019,0,1,1
150795, Tailândia,15,CL,2015-2019,188,153,341
150796, Terra Alta,15,CL,2015-2019,9,6,15
150797, Terra Santa,15,CL,2015-2019,8,15,23
150800, Tomé-Açu,15,CL,2015-2019,220,91,311
150803, Tracuateua,15,CL,2015-2019,35,2,37
150805, Trairão,15,CL,2015-2019,101,46,147
150808, Tucumã,15,CL,2015-2019,56,105,161
150810, Tucuruí,15,CL,2015-2019,24,139,163
150812, Ulianópolis,15,CL,2015-2019,98,126,224
150815, Uruará,15,CL,2015-2019,498,132,630
150820, Vigia,15,CL,2015-2019,7,2,9
150830, Viseu,15,CL,2015-2019,165,5,170
150835, Vitória do Xingu,15,CL,2015-2019,44,66,110
150840, Xinguara,15,CL,2015-2019,17,46,63
160010, Amapá,16,CL,2015-2019,9,13,22
160020, Calçoene,16,CL,2015-2019,207,84,291
160021, Cutias,16,CL,2015-2019,1,0,1
160023, Ferreira Gomes,16,CL,2015-2019,12,6,18
160025, Itaubal,16,CL,2015-2019,1,0,1
160027, Laranjal do Jari,16,CL,2015-2019,92,327,419
160030, Macapá,16,CL,2015-2019,41,189,230
160040, Mazagão,16,CL,2015-2019,181,9,190
160050, Oiapoque,16,CL,2015-2019,77,347,424
160015, Pedra Branca do Amapari,16,CL,2015-2019,276,169,445
160053, Porto Grande,16,CL,2015-2019,313,80,393
160055, Pracuúba,16,CL,2015-2019,13,1,14
160060, Santana,16,CL,2015-2019,63,58,121
160005, Serra do Navio,16,CL,2015-2019,188,102,290
160070, Tartarugalzinho,16,CL,2015-2019,85,72,157
160080, Vitória do Jari,16,CL,2015-2019,14,42,56
170025, Abreulândia,17,CL,2015-2019,12,5,17
170030, Aguiarnópolis,17,CL,2015-2019,5,1,6
170035, Aliança do Tocantins,17,CL,2015-2019,0,1,1
170040, Almas,17,CL,2015-2019,5,10,15
170070, Alvorada,17,CL,2015-2019,2,5,7
170100, Ananás,17,CL,2015-2019,15,26,41
170105, Angico,17,CL,2015-2019,3,3,6
170110, Aparecida do Rio Negro,17,CL,2015-2019,11,7,18
170130, Aragominas,17,CL,2015-2019,2,0,2
170190, Araguacema,17,CL,2015-2019,26,10,36
170200, Araguaçu,17,CL,2015-2019,12,8,20
170210, Araguaína,17,CL,2015-2019,6,76,82
170215, Araguanã,17,CL,2015-2019,4,5,9
170220, Araguatins,17,CL,2015-2019,8,14,22
170230, Arapoema,17,CL,2015-2019,2,4,6
170240, Arraias,17,CL,2015-2019,2,2,4
170255, Augustinópolis,17,CL,2015-2019,1,9,10
170270, Aurora do Tocantins,17,CL,2015-2019,14,16,30
170290, Axixá do Tocantins,17,CL,2015-2019,5,7,12
170300, Babaçulândia,17,CL,2015-2019,1,1,2
170305, Bandeirantes do Tocantins,17,CL,2015-2019,1,1,2
170307, Barra do Ouro,17,CL,2015-2019,0,2,2
170310, Barrolândia,17,CL,2015-2019,1,2,3
170320, Bernardo Sayão,17,CL,2015-2019,4,0,4
170330, Bom Jesus do Tocantins,17,CL,2015-2019,3,7,10
170360, Brasilândia do Tocantins,17,CL,2015-2019,3,5,8
170370, Brejinho de Nazaré,17,CL,2015-2019,6,12,18
170380, Buriti do Tocantins,17,CL,2015-2019,0,5,5
170382, Cachoeirinha,17,CL,2015-2019,2,5,7
170384, Campos Lindos,17,CL,2015-2019,0,1,1
170388, Carmolândia,17,CL,2015-2019,1,0,1
170389, Carrasco Bonito,17,CL,2015-2019,3,2,5
170390, Caseara,17,CL,2015-2019,3,1,4
170410, Centenário,17,CL,2015-2019,2,3,5
170510, Chapada da Natividade,17,CL,2015-2019,3,2,5
170460, Chapada de Areia,17,CL,2015-2019,4,1,5
170550, Colinas do Tocantins,17,CL,2015-2019,1,18,19
171670, Colméia,17,CL,2015-2019,8,7,15
170555, Combinado,17,CL,2015-2019,3,11,14
170600, Couto Magalhães,17,CL,2015-2019,12,3,15
170610, Cristalândia,17,CL,2015-2019,7,11,18
170625, Crixás do Tocantins,17,CL,2015-2019,1,0,1
170650, Darcinópolis,17,CL,2015-2019,3,1,4
170700, Dianópolis,17,CL,2015-2019,17,21,38
170710, Divinópolis do Tocantins,17,CL,2015-2019,11,9,20
170720, Dois Irmãos do Tocantins,17,CL,2015-2019,14,8,22
170730, Dueré,17,CL,2015-2019,1,4,5
170740, Esperantina,17,CL,2015-2019,6,8,14
170755, Fátima,17,CL,2015-2019,2,2,4
170765, Figueirópolis,17,CL,2015-2019,2,3,5
170770, Filadélfia,17,CL,2015-2019,3,1,4
170820, Formoso do Araguaia,17,CL,2015-2019,4,7,11
170825, Fortaleza do Tabocão,17,CL,2015-2019,1,8,9
170830, Goianorte,17,CL,2015-2019,8,3,11
170900, Goiatins,17,CL,2015-2019,13,8,21
170930, Guaraí,17,CL,2015-2019,10,26,36
170950, Gurupi,17,CL,2015-2019,2,19,21
170980, Ipueiras,17,CL,2015-2019,1,1,2
171050, Itacajá,17,CL,2015-2019,10,11,21
171070, Itaguatins,17,CL,2015-2019,0,1,1
171090, Itapiratins,17,CL,2015-2019,4,3,7
171110, Itaporã do Tocantins,17,CL,2015-2019,3,3,6
171150, Jaú do Tocantins,17,CL,2015-2019,4,2,6
171180, Juarina,17,CL,2015-2019,1,1,2
171190, Lagoa da Confusão,17,CL,2015-2019,1,4,5
171195, Lagoa do Tocantins,17,CL,2015-2019,0,2,2
171200, Lajeado,17,CL,2015-2019,4,11,15
171215, Lavandeira,17,CL,2015-2019,8,9,17
171240, Lizarda,17,CL,2015-2019,1,3,4
171245, Luzinópolis,17,CL,2015-2019,3,8,11
171250, Marianópolis do Tocantins,17,CL,2015-2019,22,7,29
171270, Mateiros,17,CL,2015-2019,4,2,6
171280, Maurilândia do Tocantins,17,CL,2015-2019,0,2,2
171320, Miracema do Tocantins,17,CL,2015-2019,13,19,32
171330, Miranorte,17,CL,2015-2019,1,17,18
171360, Monte do Carmo,17,CL,2015-2019,22,22,44
171370, Monte Santo do Tocantins,17,CL,2015-2019,5,9,14
171395, Muricilândia,17,CL,2015-2019,3,1,4
171420, Natividade,17,CL,2015-2019,1,3,4
171430, Nazaré,17,CL,2015-2019,2,2,4
171488, Nova Olinda,17,CL,2015-2019,1,9,10
171500, Nova Rosalândia,17,CL,2015-2019,2,0,2
171510, Novo Acordo,17,CL,2015-2019,3,4,7
171515, Novo Alegre,17,CL,2015-2019,2,6,8
171525, Novo Jardim,17,CL,2015-2019,6,4,10
171550, Oliveira de Fátima,17,CL,2015-2019,0,1,1
172100, Palmas,17,CL,2015-2019,11,175,186
171570, Palmeirante,17,CL,2015-2019,1,1,2
171380, Palmeiras do Tocantins,17,CL,2015-2019,8,2,10
171575, Palmeirópolis,17,CL,2015-2019,1,13,14
171610, Paraíso do Tocantins,17,CL,2015-2019,1,34,35
171620, Paranã,17,CL,2015-2019,3,1,4
171630, Pau D'Arco,17,CL,2015-2019,1,5,6
171650, Pedro Afonso,17,CL,2015-2019,3,11,14
171660, Peixe,17,CL,2015-2019,2,2,4
171665, Pequizeiro,17,CL,2015-2019,2,1,3
171700, Pindorama do Tocantins,17,CL,2015-2019,4,6,10
171720, Piraquê,17,CL,2015-2019,6,4,10
171750, Pium,17,CL,2015-2019,15,10,25
171780, Ponte Alta do Bom Jesus,17,CL,2015-2019,2,1,3
171790, Ponte Alta do Tocantins,17,CL,2015-2019,18,36,54
171800, Porto Alegre do Tocantins,17,CL,2015-2019,5,0,5
171820, Porto Nacional,17,CL,2015-2019,9,59,68
171830, Praia Norte,17,CL,2015-2019,1,0,1
171840, Presidente Kennedy,17,CL,2015-2019,3,2,5
171845, Pugmil,17,CL,2015-2019,0,2,2
171850, Recursolândia,17,CL,2015-2019,18,5,23
171855, Riachinho,17,CL,2015-2019,7,5,12
171865, Rio da Conceição,17,CL,2015-2019,0,7,7
171870, Rio dos Bois,17,CL,2015-2019,4,3,7
171875, Rio Sono,17,CL,2015-2019,4,4,8
171884, Sandolândia,17,CL,2015-2019,17,11,28
171886, Santa Fé do Araguaia,17,CL,2015-2019,4,2,6
171888, Santa Maria do Tocantins,17,CL,2015-2019,2,2,4
171889, Santa Rita do Tocantins,17,CL,2015-2019,4,0,4
171890, Santa Rosa do Tocantins,17,CL,2015-2019,3,3,6
171900, Santa Tereza do Tocantins,17,CL,2015-2019,4,9,13
172000, Santa Terezinha do Tocantins,17,CL,2015-2019,1,2,3
172010, São Bento do Tocantins,17,CL,2015-2019,12,7,19
172020, São Miguel do Tocantins,17,CL,2015-2019,7,7,14
172025, São Salvador do Tocantins,17,CL,2015-2019,1,0,1
172030, São Sebastião do Tocantins,17,CL,2015-2019,0,4,4
172049, São Valério,17,CL,2015-2019,0,1,1
172065, Silvanópolis,17,CL,2015-2019,5,11,16
172080, Sítio Novo do Tocantins,17,CL,2015-2019,3,10,13
172090, Taguatinga,17,CL,2015-2019,11,22,33
172110, Tocantínia,17,CL,2015-2019,46,26,72
172120, Tocantinópolis,17,CL,2015-2019,13,9,22
172125, Tupirama,17,CL,2015-2019,0,2,2
172130, Tupiratins,17,CL,2015-2019,3,3,6
172208, Wanderlândia,17,CL,2015-2019,7,6,13
172210, Xambioá,17,CL,2015-2019,6,17,23
210005, Açailândia,21,CL,2015-2019,42,196,238
210020, Alcântara,21,CL,2015-2019,106,54,160
210040, Altamira do Maranhão,21,CL,2015-2019,7,1,8
210043, Alto Alegre do Maranhão,21,CL,2015-2019,1,4,5
210047, Alto Alegre do Pindaré,21,CL,2015-2019,111,45,156
210050, Alto Parnaíba,21,CL,2015-2019,1,1,2
210055, Amapá do Maranhão,21,CL,2015-2019,13,24,37
210060, Amarante do Maranhão,21,CL,2015-2019,72,51,123
210070, Anajatuba,21,CL,2015-2019,8,4,12
210083, Apicum-Açu,21,CL,2015-2019,2,1,3
210087, Araguanã,21,CL,2015-2019,31,16,47
210095, Arame,21,CL,2015-2019,24,19,43
210100, Arari,21,CL,2015-2019,1,0,1
210110, Axixá,21,CL,2015-2019,45,4,49
210120, Bacabal,21,CL,2015-2019,5,9,14
210125, Bacabeira,21,CL,2015-2019,2,1,3
210130, Bacuri,21,CL,2015-2019,2,3,5
210140, Balsas,21,CL,2015-2019,8,15,23
210160, Barra do Corda,21,CL,2015-2019,38,24,62
210170, Barreirinhas,21,CL,2015-2019,5,1,6
210177, Bela Vista do Maranhão,21,CL,2015-2019,2,3,5
210190, Bequimão,21,CL,2015-2019,6,3,9
210193, Bernardo do Mearim,21,CL,2015-2019,1,0,1
210197, Boa Vista do Gurupi,21,CL,2015-2019,10,12,22
210200, Bom Jardim,21,CL,2015-2019,66,13,79
210203, Bom Jesus das Selvas,21,CL,2015-2019,20,27,47
210207, Bom Lugar,21,CL,2015-2019,4,0,4
210215, Brejo de Areia,21,CL,2015-2019,18,4,22
210220, Buriti,21,CL,2015-2019,1,0,1
210230, Buriti Bravo,21,CL,2015-2019,7,10,17
210232, Buriticupu,21,CL,2015-2019,67,78,145
210235, Buritirana,21,CL,2015-2019,2,7,9
210237, Cachoeira Grande,21,CL,2015-2019,13,6,19
210250, Cajari,21,CL,2015-2019,1,0,1
210255, Campestre do Maranhão,21,CL,2015-2019,3,16,19
210260, Cândido Mendes,21,CL,2015-2019,84,53,137
210270, Cantanhede,21,CL,2015-2019,16,29,45
210275, Capinzal do Norte,21,CL,2015-2019,3,3,6
210280, Carolina,21,CL,2015-2019,5,16,21
210290, Carutapera,21,CL,2015-2019,26,43,69
210310, Cedral,21,CL,2015-2019,9,2,11
210312, Central do Maranhão,21,CL,2015-2019,1,3,4
210315, Centro do Guilherme,21,CL,2015-2019,19,16,35
210317, Centro Novo do Maranhão,21,CL,2015-2019,46,20,66
210325, Cidelândia,21,CL,2015-2019,16,14,30
210330, Codó,21,CL,2015-2019,43,24,67
210350, Colinas,21,CL,2015-2019,22,35,57
210355, Conceição do Lago-Açu,21,CL,2015-2019,0,2,2
210360, Coroatá,21,CL,2015-2019,13,25,38
210370, Cururupu,21,CL,2015-2019,5,14,19
210375, Davinópolis,21,CL,2015-2019,2,6,8
210380, Dom Pedro,21,CL,2015-2019,3,7,10
210400, Esperantinópolis,21,CL,2015-2019,18,7,25
210405, Estreito,21,CL,2015-2019,0,4,4
210407, Feira Nova do Maranhão,21,CL,2015-2019,7,2,9
210408, Fernando Falcão,21,CL,2015-2019,21,3,24
210409, Formosa da Serra Negra,21,CL,2015-2019,28,8,36
210410, Fortaleza dos Nogueiras,21,CL,2015-2019,6,4,10
210420, Fortuna,21,CL,2015-2019,7,3,10
210430, Godofredo Viana,21,CL,2015-2019,14,33,47
210440, Gonçalves Dias,21,CL,2015-2019,11,9,20
210450, Governador Archer,21,CL,2015-2019,2,3,5
210455, Governador Edison Lobão,21,CL,2015-2019,2,3,5
210460, Governador Eugênio Barros,21,CL,2015-2019,6,4,10
210462, Governador Luiz Rocha,21,CL,2015-2019,1,3,4
210465, Governador Newton Bello,21,CL,2015-2019,11,20,31
210467, Governador Nunes Freire,21,CL,2015-2019,44,87,131
210470, Graça Aranha,21,CL,2015-2019,0,3,3
210480, Grajaú,21,CL,2015-2019,26,36,62
210490, Guimarães,21,CL,2015-2019,11,2,13
210500, Humberto de Campos,21,CL,2015-2019,2,0,2
210510, Icatu,21,CL,2015-2019,23,2,25
210515, Igarapé do Meio,21,CL,2015-2019,2,5,7
210520, Igarapé Grande,21,CL,2015-2019,5,7,12
210530, Imperatriz,21,CL,2015-2019,4,153,157
210535, Itaipava do Grajaú,21,CL,2015-2019,7,9,16
210540, Itapecuru Mirim,21,CL,2015-2019,35,22,57
210542, Itinga do Maranhão,21,CL,2015-2019,25,56,81
210545, Jatobá,21,CL,2015-2019,10,2,12
210547, Jenipapo dos Vieiras,21,CL,2015-2019,5,2,7
210550, João Lisboa,21,CL,2015-2019,14,16,30
210560, Joselândia,21,CL,2015-2019,8,2,10
210565, Junco do Maranhão,21,CL,2015-2019,16,9,25
210570, Lago da Pedra,21,CL,2015-2019,19,71,90
210580, Lago do Junco,21,CL,2015-2019,11,5,16
210594, Lago dos Rodrigues,21,CL,2015-2019,1,5,6
210590, Lago Verde,21,CL,2015-2019,2,2,4
210592, Lagoa do Mato,21,CL,2015-2019,0,1,1
210596, Lagoa Grande do Maranhão,21,CL,2015-2019,14,5,19
210598, Lajeado Novo,21,CL,2015-2019,7,4,11
210600, Lima Campos,21,CL,2015-2019,5,2,7
210610, Loreto,21,CL,2015-2019,1,3,4
210620, Luís Domingues,21,CL,2015-2019,2,40,42
210632, Maracaçumé,21,CL,2015-2019,11,41,52
210635, Marajá do Sena,21,CL,2015-2019,14,2,16
210637, Maranhãozinho,21,CL,2015-2019,22,28,50
210650, Matinha,21,CL,2015-2019,1,0,1
210663, Matões do Norte,21,CL,2015-2019,2,1,3
210670, Mirador,21,CL,2015-2019,23,14,37
210675, Miranda do Norte,21,CL,2015-2019,0,2,2
210680, Mirinzal,21,CL,2015-2019,15,16,31
210690, Monção,21,CL,2015-2019,0,2,2
210700, Montes Altos,21,CL,2015-2019,13,11,24
210710, Morros,21,CL,2015-2019,62,24,86
210720, Nina Rodrigues,21,CL,2015-2019,1,0,1
210725, Nova Colinas,21,CL,2015-2019,2,3,5
210730, Nova Iorque,21,CL,2015-2019,2,0,2
210735, Nova Olinda do Maranhão,21,CL,2015-2019,22,6,28
210740, Olho d'Água das Cunhãs,21,CL,2015-2019,2,8,10
210745, Olinda Nova do Maranhão,21,CL,2015-2019,1,2,3
210750, Paço do Lumiar,21,CL,2015-2019,1,2,3
210760, Palmeirândia,21,CL,2015-2019,1,2,3
210770, Paraibano,21,CL,2015-2019,4,2,6
210800, Pastos Bons,21,CL,2015-2019,3,13,16
210810, Paulo Ramos,21,CL,2015-2019,18,28,46
210820, Pedreiras,21,CL,2015-2019,2,7,9
210825, Pedro do Rosário,21,CL,2015-2019,33,10,43
210845, Peritoró,21,CL,2015-2019,15,4,19
210850, Pindaré-Mirim,21,CL,2015-2019,8,2,10
210860, Pinheiro,21,CL,2015-2019,19,22,41
210870, Pio XII,21,CL,2015-2019,7,10,17
210880, Pirapemas,21,CL,2015-2019,11,6,17
210890, Poção de Pedras,21,CL,2015-2019,11,9,20
210900, Porto Franco,21,CL,2015-2019,9,11,20
210905, Porto Rico do Maranhão,21,CL,2015-2019,15,3,18
210910, Presidente Dutra,21,CL,2015-2019,2,11,13
210920, Presidente Juscelino,21,CL,2015-2019,14,1,15
210923, Presidente Médici,21,CL,2015-2019,3,9,12
210927, Presidente Sarney,21,CL,2015-2019,13,2,15
210930, Presidente Vargas,21,CL,2015-2019,25,5,30
210945, Raposa,21,CL,2015-2019,2,0,2
210950, Riachão,21,CL,2015-2019,3,6,9
210955, Ribamar Fiquene,21,CL,2015-2019,4,0,4
210960, Rosário,21,CL,2015-2019,20,5,25
210970, Sambaíba,21,CL,2015-2019,1,1,2
210975, Santa Filomena do Maranhão,21,CL,2015-2019,1,0,1
210980, Santa Helena,21,CL,2015-2019,1,16,17
210990, Santa Inês,21,CL,2015-2019,13,37,50
211000, Santa Luzia,21,CL,2015-2019,115,53,168
211003, Santa Luzia do Paruá,21,CL,2015-2019,23,50,73
211020, Santa Rita,21,CL,2015-2019,13,1,14
211027, Santo Amaro do Maranhão,21,CL,2015-2019,1,1,2
211030, Santo Antônio dos Lopes,21,CL,2015-2019,9,3,12
211040, São Benedito do Rio Preto,21,CL,2015-2019,1,0,1
211050, São Bento,21,CL,2015-2019,5,2,7
211065, São Domingos do Azeitão,21,CL,2015-2019,NA,NA,2
211070, São Domingos do Maranhão,21,CL,2015-2019,27,33,60
211085, São Francisco do Brejão,21,CL,2015-2019,7,6,13
211102, São João do Carú,21,CL,2015-2019,42,29,71
211105, São João do Paraíso,21,CL,2015-2019,7,4,11
211107, São João do Soter,21,CL,2015-2019,9,1,10
211120, São José de Ribamar,21,CL,2015-2019,2,7,9
211125, São José dos Basílios,21,CL,2015-2019,1,2,3
211130, São Luís,21,CL,2015-2019,8,31,39
211140, São Luís Gonzaga do Maranhão,21,CL,2015-2019,1,3,4
211150, São Mateus do Maranhão,21,CL,2015-2019,0,1,1
211153, São Pedro da Água Branca,21,CL,2015-2019,0,11,11
211160, São Raimundo das Mangabeiras,21,CL,2015-2019,0,5,5
211163, São Raimundo do Doca Bezerra,21,CL,2015-2019,2,0,2
211167, São Roberto,21,CL,2015-2019,3,3,6
211170, São Vicente Ferrer,21,CL,2015-2019,0,1,1
211176, Senador La Rocque,21,CL,2015-2019,4,6,10
211178, Serrano do Maranhão,21,CL,2015-2019,5,0,5
211180, Sítio Novo,21,CL,2015-2019,28,7,35
211190, Sucupira do Norte,21,CL,2015-2019,4,7,11
211200, Tasso Fragoso,21,CL,2015-2019,1,1,2
211210, Timbiras,21,CL,2015-2019,10,13,23
211223, Trizidela do Vale,21,CL,2015-2019,2,7,9
211227, Tufilândia,21,CL,2015-2019,8,4,12
211230, Tuntum,21,CL,2015-2019,9,4,13
211240, Turiaçu,21,CL,2015-2019,108,25,133
211245, Turilândia,21,CL,2015-2019,9,16,25
211250, Tutóia,21,CL,2015-2019,1,0,1
211260, Urbano Santos,21,CL,2015-2019,2,3,5
211270, Vargem Grande,21,CL,2015-2019,19,15,34
211280, Viana,21,CL,2015-2019,8,1,9
211285, Vila Nova dos Martírios,21,CL,2015-2019,2,10,12
211290, Vitória do Mearim,21,CL,2015-2019,0,1,1
211300, Vitorino Freire,21,CL,2015-2019,37,113,150
211400, Zé Doca,21,CL,2015-2019,111,46,157
220225, Canavieira,22,CL,2015-2019,0,1,1
250750, João Pessoa,25,CL,2015-2019,0,1,1
311770, Conceição do Rio Verde,31,CL,2015-2019,NA,NA,1
313020, Igaratinga,31,CL,2015-2019,0,1,1
315570, Rio Piracicaba,31,CL,2015-2019,0,1,1
320530, Vitória,32,CL,2015-2019,0,1,1
330540, Sapucaia,33,CL,2015-2019,0,1,1
350950, Campinas,35,CL,2015-2019,0,2,2
353440, Osasco,35,CL,2015-2019,0,1,1
355710, Votuporanga,35,CL,2015-2019,0,1,1
410140, Apucarana,41,CL,2015-2019,0,1,1
410480, Cascavel,41,CL,2015-2019,0,1,1
410690, Curitiba,41,CL,2015-2019,0,1,1
411850, Pato Branco,41,CL,2015-2019,0,1,1
420230, Biguaçu,42,CL,2015-2019,0,1,1
420460, Criciúma,42,CL,2015-2019,0,1,1
421060, Massaranduba,42,CL,2015-2019,0,1,1
421670, São José do Cedro,42,CL,2015-2019,0,1,1
510010, Acorizal,51,CL,2015-2019,9,5,14
510020, Água Boa,51,CL,2015-2019,38,55,93
510025, Alta Floresta,51,CL,2015-2019,41,126,167
510030, Alto Araguaia,51,CL,2015-2019,7,22,29
510035, Alto Boa Vista,51,CL,2015-2019,38,17,55
510040, Alto Garças,51,CL,2015-2019,1,12,13
510050, Alto Paraguai,51,CL,2015-2019,42,33,75
510060, Alto Taquari,51,CL,2015-2019,3,12,15
510080, Apiacás,51,CL,2015-2019,39,34,73
510100, Araguaiana,51,CL,2015-2019,4,20,24
510120, Araguainha,51,CL,2015-2019,2,7,9
510125, Araputanga,51,CL,2015-2019,18,19,37
510130, Arenápolis,51,CL,2015-2019,2,20,22
510140, Aripuanã,51,CL,2015-2019,117,96,213
510170, Barra do Bugres,51,CL,2015-2019,50,43,93
510180, Barra do Garças,51,CL,2015-2019,129,260,389
510185, Bom Jesus do Araguaia,51,CL,2015-2019,53,25,78
510190, Brasnorte,51,CL,2015-2019,196,31,227
510250, Cáceres,51,CL,2015-2019,56,115,171
510260, Campinápolis,51,CL,2015-2019,311,45,356
510263, Campo Novo do Parecis,51,CL,2015-2019,24,45,69
510267, Campo Verde,51,CL,2015-2019,47,45,92
510268, Campos de Júlio,51,CL,2015-2019,13,24,37
510269, Canabrava do Norte,51,CL,2015-2019,39,34,73
510270, Canarana,51,CL,2015-2019,136,47,183
510279, Carlinda,51,CL,2015-2019,22,21,43
510285, Castanheira,51,CL,2015-2019,44,12,56
510300, Chapada dos Guimarães,51,CL,2015-2019,113,52,165
510305, Cláudia,51,CL,2015-2019,80,65,145
510310, Cocalinho,51,CL,2015-2019,4,1,5
510320, Colíder,51,CL,2015-2019,35,76,111
510325, Colniza,51,CL,2015-2019,163,92,255
510330, Comodoro,51,CL,2015-2019,117,72,189
510335, Confresa,51,CL,2015-2019,51,61,112
510336, Conquista D'Oeste,51,CL,2015-2019,16,6,22
510337, Cotriguaçu,51,CL,2015-2019,128,50,178
510340, Cuiabá,51,CL,2015-2019,34,263,297
510343, Curvelândia,51,CL,2015-2019,3,3,6
510345, Denise,51,CL,2015-2019,10,8,18
510350, Diamantino,51,CL,2015-2019,85,61,146
510360, Dom Aquino,51,CL,2015-2019,4,10,14
510370, Feliz Natal,51,CL,2015-2019,55,76,131
510380, Figueirópolis D'Oeste,51,CL,2015-2019,0,2,2
510385, Gaúcha do Norte,51,CL,2015-2019,79,12,91
510390, General Carneiro,51,CL,2015-2019,49,41,90
510395, Glória D'Oeste,51,CL,2015-2019,2,0,2
510410, Guarantã do Norte,51,CL,2015-2019,30,82,112
510420, Guiratinga,51,CL,2015-2019,51,57,108
510450, Indiavaí,51,CL,2015-2019,1,1,2
510452, Ipiranga do Norte,51,CL,2015-2019,4,8,12
510454, Itanhangá,51,CL,2015-2019,17,12,29
510455, Itaúba,51,CL,2015-2019,18,51,69
510460, Itiquira,51,CL,2015-2019,10,9,19
510480, Jaciara,51,CL,2015-2019,8,41,49
510490, Jangada,51,CL,2015-2019,16,6,22
510500, Jauru,51,CL,2015-2019,15,5,20
510510, Juara,51,CL,2015-2019,44,83,127
510515, Juína,51,CL,2015-2019,94,126,220
510517, Juruena,51,CL,2015-2019,36,39,75
510520, Juscimeira,51,CL,2015-2019,3,9,12
510523, Lambari D'Oeste,51,CL,2015-2019,6,2,8
510525, Lucas do Rio Verde,51,CL,2015-2019,14,157,171
510530, Luciara,51,CL,2015-2019,1,8,9
510558, Marcelândia,51,CL,2015-2019,36,117,153
510560, Matupá,51,CL,2015-2019,14,49,63
510562, Mirassol d'Oeste,51,CL,2015-2019,7,30,37
510590, Nobres,51,CL,2015-2019,21,12,33
510600, Nortelândia,51,CL,2015-2019,22,16,38
510610, Nossa Senhora do Livramento,51,CL,2015-2019,27,3,30
510615, Nova Bandeirantes,51,CL,2015-2019,39,27,66
510620, Nova Brasilândia,51,CL,2015-2019,28,12,40
510621, Nova Canaã do Norte,51,CL,2015-2019,26,16,42
510880, Nova Guarita,51,CL,2015-2019,9,12,21
510618, Nova Lacerda,51,CL,2015-2019,21,10,31
510885, Nova Marilândia,51,CL,2015-2019,6,3,9
510890, Nova Maringá,51,CL,2015-2019,64,59,123
510895, Nova Monte Verde,51,CL,2015-2019,20,14,34
510622, Nova Mutum,51,CL,2015-2019,69,102,171
510617, Nova Nazaré,51,CL,2015-2019,47,6,53
510623, Nova Olímpia,51,CL,2015-2019,3,13,16
510619, Nova Santa Helena,51,CL,2015-2019,6,12,18
510624, Nova Ubiratã,51,CL,2015-2019,49,14,63
510625, Nova Xavantina,51,CL,2015-2019,23,58,81
510627, Novo Horizonte do Norte,51,CL,2015-2019,6,9,15
510626, Novo Mundo,51,CL,2015-2019,25,16,41
510631, Novo Santo Antônio,51,CL,2015-2019,13,11,24
510628, Novo São Joaquim,51,CL,2015-2019,34,18,52
510629, Paranaíta,51,CL,2015-2019,24,25,49
510630, Paranatinga,51,CL,2015-2019,104,74,178
510637, Pedra Preta,51,CL,2015-2019,11,18,29
510642, Peixoto de Azevedo,51,CL,2015-2019,60,97,157
510645, Planalto da Serra,51,CL,2015-2019,13,17,30
510650, Poconé,51,CL,2015-2019,11,8,19
510665, Pontal do Araguaia,51,CL,2015-2019,26,31,57
510670, Ponte Branca,51,CL,2015-2019,11,21,32
510675, Pontes e Lacerda,51,CL,2015-2019,36,116,152
510677, Porto Alegre do Norte,51,CL,2015-2019,9,27,36
510680, Porto dos Gaúchos,51,CL,2015-2019,36,22,58
510682, Porto Esperidião,51,CL,2015-2019,15,2,17
510685, Porto Estrela,51,CL,2015-2019,8,1,9
510700, Poxoréo,51,CL,2015-2019,109,36,145
510704, Primavera do Leste,51,CL,2015-2019,17,131,148
510706, Querência,51,CL,2015-2019,60,19,79
510715, Reserva do Cabaçal,51,CL,2015-2019,8,6,14
510718, Ribeirão Cascalheira,51,CL,2015-2019,161,91,252
510719, Ribeirãozinho,51,CL,2015-2019,3,4,7
510720, Rio Branco,51,CL,2015-2019,0,6,6
510757, Rondolândia,51,CL,2015-2019,15,2,17
510760, Rondonópolis,51,CL,2015-2019,15,135,150
510770, Rosário Oeste,51,CL,2015-2019,39,16,55
510775, Salto do Céu,51,CL,2015-2019,10,8,18
510724, Santa Carmem,51,CL,2015-2019,12,30,42
510774, Santa Cruz do Xingu,51,CL,2015-2019,7,13,20
510776, Santa Rita do Trivelato,51,CL,2015-2019,29,21,50
510777, Santa Terezinha,51,CL,2015-2019,21,5,26
510726, Santo Afonso,51,CL,2015-2019,5,3,8
510779, Santo Antônio do Leste,51,CL,2015-2019,17,5,22
510780, Santo Antônio do Leverger,51,CL,2015-2019,25,4,29
510785, São Félix do Araguaia,51,CL,2015-2019,30,6,36
510729, São José do Povo,51,CL,2015-2019,3,5,8
510730, São José do Rio Claro,51,CL,2015-2019,49,153,202
510735, São José do Xingu,51,CL,2015-2019,22,15,37
510710, São José dos Quatro Marcos,51,CL,2015-2019,2,3,5
510740, São Pedro da Cipa,51,CL,2015-2019,1,5,6
510787, Sapezal,51,CL,2015-2019,3,30,33
510788, Serra Nova Dourada,51,CL,2015-2019,16,6,22
510790, Sinop,51,CL,2015-2019,41,558,599
510792, Sorriso,51,CL,2015-2019,27,134,161
510794, Tabaporã,51,CL,2015-2019,31,36,67
510795, Tangará da Serra,51,CL,2015-2019,38,109,147
510800, Tapurah,51,CL,2015-2019,18,61,79
510805, Terra Nova do Norte,51,CL,2015-2019,27,17,44
510810, Tesouro,51,CL,2015-2019,25,52,77
510820, Torixoréu,51,CL,2015-2019,23,29,52
510830, União do Sul,51,CL,2015-2019,38,27,65
510835, Vale de São Domingos,51,CL,2015-2019,3,3,6
510840, Várzea Grande,51,CL,2015-2019,4,87,91
510850, Vera,51,CL,2015-2019,12,30,42
510550, Vila Bela da Santíssima Trindade,51,CL,2015-2019,29,7,36
510860, Vila Rica,51,CL,2015-2019,26,20,46
510000, Município ignorado - MT,51,CL,2015-2019,NA,NA,1
520130, Anicuns,52,CL,2015-2019,0,1,1
520310, Baliza,52,CL,2015-2019,0,1,1
520725, Doverlândia,52,CL,2015-2019,4,3,7
520890, Goiás,52,CL,2015-2019,1,0,1
521350, Monte Alegre de Goiás,52,CL,2015-2019,0,1,1
522160, Uruaçu,52,CL,2015-2019,0,1,1
